Sr.,Particulars,Qty,Rate,Total,Date,,,,,,,,,,,
1,Upper Cover United,1014,40,40560,10-Oct-11,,Date,INV- GP,Details,Debit,Credit,Balance,,,,
2,Back Cover 70,2519,32,80608,,,10-Oct,847,,127234,148750,-21516,,,,
3,Housing 70,674,9,6066,,,14-Oct,852,,66558,,45042,,,,
4,,,,127234,,,17-Oct,857,,38427,,83469,,,,
5,Upper Cover United,741,40,29640,14-Oct-11,,19-Oct,859,,45189,,128658,,,,
6,Housing 70,602,9,5418,,,22-Oct,871,,37752,,166410,,,,
7,Dial Blank 70,3500,9,31500,,,16-Dec,830,,6400,,172810,,,,
8,,,,66558,,,17-Dec,,Cheque HBL,,50000,122810,,,,
9,Upper Cover United,507,40,20280,17-Oct-11,,11-Feb,891,,69850,,192660,,,,
10,Back Cover 70,465,32,14880,,,21-Feb,602,,19825,,212485,,,,
11,Housing 70,363,9,3267,,,01-Mar,610,,82441,,294926,,,,
12,,,,38427,,,07-Mar,616,,56960,,351886,,,,
13,Upper Cover United,503,40,20120,19-Oct-11,,20-Mar,,Cheque# 0118276 (HBL),,100000,251886,,,,
14,Back Cover 70,521,32,16672,,,12-Mar-12,623,,40448,,292334,,,,
15,Housing 70,933,9,8397,,,16-Mar-12,629,,46766,,339100,,,,
16,,,,45189,,,21-Mar-12,630,,49702,,388802,,,,
17,Upper Cover United,735,40,29400,22-Oct-11,,11-Apr-12,,Cheque# 0046098 (HBL),,150000,238802,,,,
18,Housing 70,928,9,8352,,,30-Mar-12,633,,46312,,285114,,,,
19,,,,37752,,,04-Apr-12,643,,50368,,335482,,,,
20,Upper Cover 70 New,100,40,4000,16-Dec-11,,06-Apr-12,647,,22410,,357892,,,,
21, Meter Wire 70,100,24,2400,,,09-Apr-12,654,,40024,,397916,,,,
22,,,,6400,,,11-Apr-12,655,,77951,,475867,,,,
23,Dial Blank 70,1100,9,9900,11-Feb-12,,19-Apr-12,663,,74172,,550039,,,,
24,Upper Cover 70 New,100,40,4000,,,28-Apr-12,,,40328,,590367,,,,
25,Dial Blank 70,150,9,1350,,,13-May-12,,Cheque# 0261043 (HBL),,200000,390367,,,,
26,Printed Dial 70,1170,7,8190,,,02-May-12,1,,70766,,461133,,,,
27,Upper Cover Hi Speed,1105,42,46410,,,03-May-12,,Cheque# 0227935 (HBL),,40000,421133,,,,
28,,,,69850,,,05-May-12,2,,38228,,459361,,,,
29,Dial Blank 70,425,9,3825,21-Feb-12,,08-May-12,3,,35558,,494919,,,,
30,Upper Cover 70 New,400,40,16000,,,11-May-12,4,,42188,,537107,,,,
31,,,,19825,,,15-May-12,5,,43703,,580810,,,,
32,Dial Blank 70,325,9,2925,01-Mar-12,,03-Dec-11,,Cheque HBL,,50000,530810,,,,
33,Dial Blank 70,700,9,6300,,,22-May-12,6,,77533,,608343,,,,
34,Upper Cover 70 New,150,40,6000,,,25-May-12,7,,47226,,655569,,,,
35,Meter Wire,150,24,3600,,,28-May-12,8,,27830,,683399,,,,
36,Dial Blank 70,1000,9,9000,,,15-Jun,,Cheque# 0261100 (HBL),,350000,333399,,,,
37,Dial Printed 70,535,7,3745,,,01-Jun,9,,34881,,368280,,,,
38,Dial Printed Challenger,423,7,2961,,,02-Jun,10,,61218,,429498,,,,
39,Upper Cover United,618,40,24720,,,07-Jun,11,,70695,,500193,,,,
40,Back Cover 70,570,32,18240,,,06-09-12,12,,49339,,549532,,,,
41,Housing 70,550,9,4950,,,11-Jun,13,,38944,,588476,,,,
42,,,,82441,,,14-Jun,14,,53204,,641680,,,,
43,Pointer Given,3000,9,27000,01-Mar-12,,18-Jun,15,,30564,,672244,,,,
44,Dial Blank 70,3000,9,27000,07-Mar-12,,06-21-12,16,,34988,,707232,,,,
45,Upper Cover Zxmco,441,40,17640,,,07-20-12,,Cheque# 0227983 HBL,,420000,287232,,,,
46,Back Cover 70,385,32,12320,,,07-02-12,17,,85575,,372807,,,,
47,,,,56960,,,07-05-12,18,,46295,,419102,,,,
48,Upper Cover Zxmco,507,42,21294,12-Mar-12,,07-09-12,19,,52115,,471217,,,,
49,Back Cover 70,454,32,14528,,,07-11-12,20,,24969,,496186,,,,
50,Housing 70,514,9,4626,,,07-14-12,21,,24763,,520949,,,,
51,,,,40448,,,07-19-12,22,,26240,,547189,,,,
52,Upper Cover united,563,40,22520,16-Mar-12,,07-21-12,23,,20069,,567258,,,,
53,Back Cover 70,594,32,19008,,,08-01-12,24,,36761,,604019,,,,
54,Housing 70 black,582,9,5238,,,08-03-12,25,,59739,,663758,,,,
55,,,,46766,,,08-06-12,26,,53420,,717178,,,,
56,Dial Blank Quinque,125,12,1500,21-Mar-12,,08-07-12,27,,61099,,778277,,,,
57,Upper Cover 70,50,40,2000,,,08-08-12,28,,14928,,793205,,,,
58,Meter Wire United,500,24,12000,,,08-17-12,,Cheq# 0372919 HBL,,150000,643205,,,,
59,Upper Cover 70 New,250,40,10000,,,08-25-12,,Cheq# 0372925 HBL,,150000,493205,,,,
60,Upper Cover United 70,305,40,12200,,,08-11-12,29,,40499,,533704,,,,
61,Back Cover 70,190,32,6080,,,08-28-12,30,,57080,,590784,,,,
62,Housing 70 Blue,250,9,2250,,,08-30-12,31,,46901,,637685,,,,
63,Housing 70 black,408,9,3672,,,09-01-12,32,,63118,,700803,,,,
64,,,,49702,,,09-03-12,33,,43860,,744663,,,,
1,Back Cover 70,189,32,6048,30-Mar-12,,09-17-12,,,37196,,982751,,,,
2,Back Cover 70,204,32,6528,,,09-18-12,,Cheq# 0372982 HBL,,275000,707751,,,,
3,Back Cover 70,102,32,3264,,,09-18-12,,Cheq# CD-8733032 Alfalah B,,100000,607751,,,,
4,housing 70,132,9,1188,,,09-20-12,40,,42858,,650609,,,,
5,upper Cover 70,92,40,3680,,,09-24-12,41,,41284,,691893,,,,
6,Meter Wire 70,500,24,12000,,,09-26-12,42,,67960,,759853,,,,
7,Upper Cover Unique,247,40,9880,,,09-27-12,43,,56428,,816281,,,,
8,Back Cover 70,77,32,2464,,,10-01-12,44,,68254,,884535,,,,
9,housing 70,140,9,1260,,,10-05-12,45,,49991,,934526,,,,
10,,,,46312,,,10-08-12,46,,65125,,999651,,,,
11,Back Cover 70,154,32,4928,04-Apr-12,,10-11-12,47,,60000,,1059651,,,,
12,housing 70 Black,240,9,2160,,,10-13-12,48,,60829,,1120480,,,,
13,Upper Cover United,240,40,9600,,,10-18-12,,Cheq# 0432903 HBL,,450000,670480,,,,
14,Upper Cover 70,170,40,6800,,,09-19-12,36,,41682,,712162,,,,
15,housing 70,260,9,2340,,,10-17-12,49,,60232,,772394,,,,
16,Dial Blank 70,1500,9,13500,,,10-24-12,50,,82516,,854910,,,,
17,housing 70 black,160,9,1440,,,10-25-12,51,,53464,,908374,,,,
18,Upper Cover Zxmco,240,40,9600,,,11-01-12,52,,62609,,970983,,,,
19,,,,50368,,,11-05-12,53,,84828,,1055811,,,,
20,Upper Cover Zxmco,284,40,11360,06-Apr-12,,11-07-12,54,,60720,,1116531,,,,
21,Back Cover 70,167,32,5344,,,11-07-12,55,,66908,,1183439,,,,
22,housing 70,634,9,5706,,,11-12-12,56,,51302,,1234741,,,,
23,,,,22410,,,11-14-12,57,,48896,,1283637,,,,
24,Dial Blank Quinque,500,12,6000,09-Apr-12,,11-15-12,,Cheq# Rp-15864701 BAF,,400000,883637,,,,
25,Dial Blank 70,400,9,3600,,,11-19-12,58,,77612,,961249,,,,
26,Upper Cover Zxmco,388,40,15520,,,11-21-12,,Cheq# 4591001 MCB,,150000,811249,,,,
27,Back Cover 70,432,32,13824,,,11-26-12,59,,89112,,900361,,,,
28,Housing 70 (Black),120,9,1080,,,11-29-12,,Cheq# 15125721 AFB,,50000,850361,,,,
29,,,,40024,,,11-29-12,60,,72482,,922843,,,,
30,Upper Cover Quinque,407,45,18315,11-Apr-12,,12-01-12,61,,53599,,976442,,,,
31,Back Cover 70,483,32,15456,,,12-03-12,62,,39609,,1016051,,,,
32,Housing 70,500,9,4500,,,12-05-12,63,,62148,,1078199,,,,
33,Nest Quinque,530,20,10600,,,12-08-12,64,,77641,,1155840,,,,
34,Housing Quinque,528,35,18480,,,12-10-12,65,,61454,,1217294,,,,
35,back cover Quinque,530,20,10600,,,12-12-12,66,,70937,,1288231,,,,
36,,,,77951,,,12-15-12,67,,41933,,1330164,,,,
37,Back Cover 70,186,32,5952,19-Apr-12,,12-12-12,,Cheq# 1088107 MBL,,300000,1030164,,,,
38,Upper Cover Zxmco,148,40,5920,,,12-17-12,68,,60180,,1090344,,,,
39,Back Cover 70,195,32,6240,,,12-17-12,,Cheq# 0181527 UBL,,35000,1055344,,,,
40,Upper Cover Zxmco,388,40,15520,,,12-17-12,,Cheq# 10029797 BAHL,,160000,895344,,,,
41,Back Cover 70,93,32,2976,,,12-20-12,,Cheq# 6708831 HBL,,105000,790344,,,,
42,Upper Cover Zxmco,424,40,16960,,,12-22-12,69,,68785,,859129,,,,
43,Back Cover 70,492,32,15744,,,12-27-12,70,,68444,,927573,,,,
44,Housing 70 (Black),540,9,4860,,,12-29-12,71,,55537,,983110,,,,
45,,,,74172,,,01-02-13,72,,94394,,1077504,,,,
46,Upper Cover Zxmco,148,40,5920,23-Apr,,01-03-13,73,,62542,,1140046,,,,
47,Dial blank 70,1000,9,9000,26-Apr-12,,01-04-13,74,,40856,,1180902,,,,
48,Upper Cover Window,444,40,17760,28-Apr-12,,01-08-13,75,,62908,,1243810,,,,
49,Back Cover 70,239,32,7648,,,01-12-13,76,,94130,,1337940,,,,
50,,,,40328,,,01-18-13,,Cheq# 15864775 BAFL,,398040,939900,,,,
51,Upper Cover Window,370,40,14800,02-May-12,,01-22-13,,Cash Received,,200000,739900,,,,
52,Back Cover 70,347,32,11104,,,01-16-13,77,,75430,,815330,,,,
53,Housing 70 Black,882,9,7938,,,01-24-13,78,,118425,,933755,,,,
54,Dial Blank 70 ,1500,9,13500,,,01-28-13,79,,132442,,1066197,,,,
55,Dial Blank Qinque,500,12,6000,,,01-29-13,80,,37780,,1103977,,,,
56,Upper Cover Window,74,40,2960,,,02-04-13,81,,82050,,1186027,,,,
57,Back Cover 70,452,32,14464,,,02-09-13,82,,65694,,1251721,,,,
58,,,,70766,,,02-14-13,83,,60379,,1312100,,,,
59,Upper Cover Window,509,40,20360,05-May-12,,02-16-13,,Cheq# 10029809 BAHL,,500000,812100,,,,
60,Back Cover 70,528,32,16896,,,02-19-13,84,,68560,,880660,,,,
61,Housing 70 Black,108,9,972,,,02-20-13,85,,67140,,947800,,,,
62,,,,38228,,,02-22-13,86,,29372,,977172,,,,
1,Housing 70 Black,574,9,5166,08-May-12,,03-26-13,89,,60925,,973177,,,,
2,Dial Blank 70,1000,9,9000,,,03-28-13,,Cash Received,,200000,773177,,,,
3,back Cover 70,430,32,13760,,,03-29-13,90,,109330,,882507,,,,
4,Housing 70 Black,848,9,7632,,,03-30-13,91,,21150,,903657,,,,
5,,,,35558,,,04-01-13,92,,50240,,953897,,,,
6,dial blank 70,300,9,2700,11-May-12,,04-02-13,93,,43902,,997799,,,,
7,Upper Cover Window 70,530,40,21200,,,04-04-13,94,,33280,,1031079,,,,
8,Back cover 70,504,32,16128,,,04-06-13,95,,25200,,1056279,,,,
9,Housing 70 black,240,9,2160,,,04-10-13,96,,14236,,1070515,,,,
10,,,,42188,,,04-15-13,97,,28080,,1098595,,,,
11,Upper Cover Window 70,74,40,2960,15-May-12,,04-16-13,,Cheq# 0672758 HBL,,300000,798595,,,,
12,Upper Cover Window 70,605,40,24200,,,04-17-13,98,,36798,,835393,,,,
13,back Cover 70,335,32,10720,,,04-23-13,99,,109040,,944433,,,,
14,Housing 70 black,647,9,5823,,,04-25-13,100,,54879,,999312,,,,
15,,,,43703,,,04-29-13,101,,33092,,1032404,,,,
16,Back Cover 70,362,32,11584,22-May-12,,05-02-13,102,,32000,,1064404,,,,
17,Upper Cover Window,242,40,9680,,,05-04-13,103,,23468,,1087872,,,,
18,Back Cover 70,552,32,17664,,,05-06-13,104,,15440,,1103312,,,,
19,Housing 70 black,446,9,4014,,,05-07-13,105,,39670,,1142982,,,,
20,Upper Cover Window,120,40,4800,,,05-08-13,106,,29960,,1172942,,,,
21,Upper Cover Window,314,40,12560,,,05-13-13,107,,81026,,1253968,,,,
22,Back Cover 70,415,32,13280,,,05-13-13,108,,59440,,1313408,,,,
23,Housing 70 black,439,9,3951,,,04-09-13,,Cheque Received,,200000,1113408,,,,
24,,,,77533,,,05-17-13,,Cheq# 0850020 HBL,,100000,1013408,,,,
25,Dial Blank 70,1000,9,9000,05-25-12,,05-17-13,109,,32836,,1046244,,,,
26,Upper Cover window,446,40,17840,,,05-21-13,110,,26980,,1073224,,,,
27,Back Cover 70,461,32,14752,,,05-22-13,111,,50616,,1123840,,,,
28,Housing 70 ,626,9,5634,,,05-24-13,112,,35048,,1158888,,,,
29,,,,47226,,,05-27-13,113,,17580,,1176468,,,,
30,Upper Cover Hi speed,296,40,11840,05-28-12,,05-29-13,,Cheq# 0850028 HBL,,300000,876468,,,,
31,Back Cover 70,408,32,13056,,,05-28-13,114,,24000,,900468,,,,
32,Housing 70 ,326,9,2934,,,05-29-13,115,,37830,,938298,,,,
33,,,,27830,,,05-30-13,116,,34320,,972618,,,,
34,Back Cover 70,519,32,16608,06-01-12,,05-31-13,117,,53300,,1025918,,,,
35,Housing 70,577,9,5193,,,06-01-13,118,,45220,,1071138,,,,
36,Meter Wire,545,24,13080,,,06-03-13,119,,46680,,1117818,,,,
37,,,,34881,,,06-03-13,120,,24000,,1141818,,,,
38,Upper Cover Window,344,40,13760,06-02-12,,06-04-13,121,,29940,,1171758,,,,
39,Back Cover 70,309,32,9888,,,06-05-13,122,,46520,,1218278,,,,
40,Upper Cover Qinque 100cc,306,45,13770,,,06-06-13,123,,44960,,1263238,,,,
41,Back Cover Qinque,300,20,6000,,,06-07-13,124,,30160,,1293398,,,,
42,Housing Qinque,320,35,11200,,,06-10-13,125,,39320,,1332718,,,,
43,Nest Qinque,330,20,6600,,,06-11-13,126,,39316,,1372034,,,,
44,,,,61218,,,06-12-13,127,,49380,,1421414,,,,
45,Upper Cover 70,74,40,2960,07-Jun,,06-13-13,128,,41220,,1462634,,,,
46,Dial Blank 70,600,9,5400,,,06-15-13,129,,26640,,1489274,,,,
47,Upper Cover Window,368,40,14720,,,06-17-13,130,,36900,,1526174,,,,
48,Back Cover 70,465,32,14880,,,06-19-13,,Cheq# 0850064 HBL,,400000,1126174,,,,
49,Housing 70 ,433,9,3897,,,06-19-13,131,,41152,,1167326,,,,
50,Upper Cover Window,146,40,5840,,,06-20-13,132,,66002,,1233328,,,,
51,Upper Cover Window,168,40,6720,,,06-24-13,133,,24800,,1258128,,,,
52,Back Cover 70,444,32,14208,,,06-25-13,134,,32960,,1291088,,,,
53,Housing 70 ,230,9,2070,,,06-29-13,135,,16862,,1307950,,,,
54,,,,70695,,,07-01-13,136,,57496,,1365446,,,,
55,Back Cover 70,779,32,24928,09-Jun-12,,07-04-13,,Cheq# 0850076 HBL,,200000,1165446,,,,
56,Housing 70,579,9,5211,,,07-03-13,137,,62170,,1227616,,,,
57,Meter Wire,800,24,19200,,,07-04-13,138,,16390,,1244006,,,,
58,,,,49339,,,07-05-13,139,,53014,,1297020,,,,
59,Upper Cover Window,454,40,18160,06-11-12,,07-06-13,140,,15480,,1312500,,,,
60,Back Cover 70,510,32,16320,,,07-09-13,141,,52790,,1365290,,,,
61,Housing 70,496,9,4464,,,07-10-13,142,,55760,,1421050,,,,
62,,,,38944,,,07-11-13,143,,65524,,1486574,,,,
1,Dial Blank 70,700,9,6300,14-Jun-12,,07-17-13,147,,40160,,1020282,,,,
2,Upper Cover Window,240,40,9600,,,07-19-13,148,,48238,,1068520,,,,
3,Upper Cover Hi speed,370,40,14800,,,07-22-13,149,,58580,,1127100,,,,
4,Upper Cover Window,222,40,8880,,,07-26-13,150,,67130,,1194230,,,,
5,Back Cover 70,338,32,10816,,,07-27-13,151,,64655,,1258885,,,,
6,Housing 70 blue,156,9,1404,,,07-29-13,152,,53836,,1312721,,,,
7,Housing 70 Black,156,9,1404,,,07-30-13,153,,26000,,1338721,,,,
8,,,,53204,,,07-31-13,154,,33560,,1372281,,,,
9,Dial Blank 70,500,9,4500,06-18-12,,08-01-13,155,,49392,,1421673,,,,
10,Upper Cover Window,222,40,8880,,,08-03-13,156,,37570,,1459243,,,,
11,Back Cover 70,420,32,13440,,,08-04-13,157,,63495,,1522738,,,,
12,Housing 70 Black,416,9,3744,,,08-05-13,158,,36864,,1559602,,,,
13,,,,30564,,,08-06-13,159,,44942,,1604544,,,,
14,Upper Cover Window,173,40,6920,06-21-12,,08-15-13,160,,23080,,1627624,,,,
15,Upper Cover 70 new,148,40,5920,,,08-16-13,161,,66520,,1694144,,,,
16,Upper Cover Window,452,40,18080,,,08-17-13,162,,46820,,1740964,,,,
17,Housing 70 ,452,9,4068,,,08-19-13,163,,60258,,1801222,,,,
18,,,,34988,,,06-01-13,,June month discount,,23620,1777602,,,,
19,Dial Blank 70,2700,9,24300,02-Jul-12,,07-01-13,,July month discount,,32384,1745218,,,,
20,Upper Cover 70 Window,388,40,15520,,,08-20-13,164,,63536,,1808754,,,,
21,upper Cover Qinque 100cc,360,45,16200,,,08-20-13,,Cheque Received,,550000,1258754,,,,
22,Back cover Qinque,500,20,10000,,,08-22-13,,Cheque received,,150000,1108754,,,,
23,nest Qinque,500,20,10000,,,08-28-13,165,,102005,,1210759,,,,
24,Housing qinque,273,35,9555,,,08-30-13,166,,49032,,1259791,,,,
25,,,,85575,,,09-02-13,167,,75512,,1335303,,,,
26,Upper Cover 70 Window,462,40,18480,07-05-12,,09-05-13,168,,84444,,1419747,,,,
27,Back Cover 70,444,32,14208,,,09-06-13,169,,48640,,1468387,,,,
28,Housing 70 ,403,9,3627,,,09-07-13,170,,58220,,1526607,,,,
29,Upper Cover 70 New,92,40,3680,,,09-09-13,171,,46882,,1573489,,,,
30,Upper Cover qinque 100cc,140,45,6300,,,09-10-13,172,,19764,,1593253,,,,
31,,,,46295,,,09-13-13,173,,25596,,1618849,,,,
32,Upper Cover 70,296,40,11840,09-Jul-12,,09-16-13,174,,52364,,1671213,,,,
33,Upper Cover Window,480,40,19200,,,09-17-13,175,,44154,,1715367,,,,
34,Back Cover 70,543,32,17376,,,09-18-13,,Cheque received,,700000,1015367,,,,
35,Housing 70,411,9,3699,,,09-19-13,176,,24120,,1039487,,,,
36,,,,52115,,,09-20-13,177,,40776,,1080263,,,,
37,Back Cover 70,627,32,20064,07-11-12,,09-21-13,178,,24740,,1105003,,,,
38,Housing 70,545,9,4905,,,09-23-13,179,,59232,,1164235,,,,
39,,,,24969,,,09-24-13,180,,71040,,1235275,,,,
40,Dial Blank 70,500,9,4500,07-14-12,,10-01-13,181,,79676,,1314951,,,,
41,Upper Cover Window,388,40,15520,,,10-03-13,182,,72432,,1387383,,,,
42,Housing 70,527,9,4743,,,10-04-13,183,,63738,,1451121,,,,
43,,,,24763,,,10-07-13,184,,36720,,1487841,,,,
44,Dial Blank Qinque,200,12,2400,07-19-12,,10-08-13,185,,48460,,1536301,,,,
45,Upper Cover Window,296,40,11840,,,10-10-13,186,,60729,,1597030,,,,
46,Cover Set Sohrab Js,100,120,12000,,,10-11-13,187,,52416,,1649446,,,,
47,,,,26240,,,10-11-13,,Cheque Received,,325000,1324446,,,,
48,Dial Blank Sohrab js,100,12,1200,07-21-12,,10-12-13,188,,33576,,1358022,,,,
49,Back Cover 70,469,32,15008,,,10-14-13,189,,29304,,1387326,,,,
50,Housing 70 Black,429,9,3861,,,10-23-13,190,,38430,,1425756,,,,
51,,,,20069,,,10-23-13,191,,16000,,1441756,,,,
52,Upper Cover Window,75,40,3000,08-01-12,,10-24-13,192,,35148,,1476904,,,,
53,Upper Cover Window,298,40,11920,,,10-25-13,193,,101060,,1577964,,,,
54,Back Cover 70,527,32,16864,,,10-29-13,,Cheq# 1127846 HBL,,325000,1252964,,,,
55,Housing 70 Black,553,9,4977,,,10-28-13,194,,63596,,1316560,,,,
56,,,,36761,,,10-30-13,195,,74756,,1391316,,,,
57,Upper Cover 70 New,611,40,24440,08-03-12,,11-02-13,196,,67990,,1459306,,,,
58,Back Cover 70,487,32,15584,,,10-31-13,197,,6000,,1465306,,,,
59,Housing Qinque,449,35,15715,,,11-05-13,198,,82762,,1548068,,,,
60,Nest Qinque,200,20,4000,,,11-07-13,199,,37962,,1586030,,,,
61,,,,59739,,,11-09-13,200,,54028,,1640058,,,,
62,Dial Blank 70,1000,9,9000,08-06-12,,11-11-13,201,,39454,,1679512,,,,
63,Dial Blank Qinque,500,12,6000,,,11-18-13,202,,43812,,1723324,,,,
64,Upper Cover Qinque 100cc,496,45,22320,,,11-19-13,,cheque Received HBL,,775000,948324,,,,
65,Back cover Qinque,505,20,10100,,,11-20-13,203,,67812,,1016136,,,,
66,Nest Qinque,300,20,6000,,,11-22-13,204,,35360,,1051496,,,,
67,,,,53420,,,11-23-13,205,,37892,,1089388,,,,
68,Upper Cover70 New,355,40,14200,08-07-12,,11-25-13,206,,64780,,1154168,,,,
69,Upper Cover Unique,252,40,10080,,,11-28-13,207,,87220,,1241388,,,,
70,Upper Cover Zxmco,220,40,8800,,,11-29-13,208,,91406,,1332794,,,,
71,Back Cover 70,679,32,21728,,,12-02-13,209,,65877,,1398671,,,,
72,Housing 70 Black,699,9,6291,,,12-04-13,210,,29668,,1428339,,,,
73,,,,61099,,,12-05-13,211,,28850,,1457189,,,,
74,Back Cover 70,327,32,10464,08-08-12,,12-06-13,212,,45574,,1502763,,,,
75,Housing 70,496,9,4464,,,12-09-13,213,,49848,,1552611,,,,
76,,,,14928,,,12-11-13,214,,69798,,1622409,,,,
77,Upper Cover Unique,258,40,10320,08-11-12,,12-13-13,,Cheq# 1213959 HBL,,400000,1222409,,,,
78,Upper Cover Window,222,40,8880,,,12-23-13,,Cheq# 1213960 Hbl,,300000,922409,,,,
79,Back Cover 70,523,32,16736,,,12-13-13,215,,79308,,1001717,,,,
80,Housing 70 Black,507,9,4563,,,12-20-13,216,,55806,,1057523,,,,
81,,,,40499,,,12-24-13,217,,40572,,1098095,,,,
82,Dial Blank 70,1000,9,9000,08-28-12,,12-26-13,218,,111910,,1210005,,,,
83,Upper Cover Window,157,40,6280,,,12-30-13,219,,126448,,1336453,,,,
84,Upper Cover Window,148,40,5920,,,01-01-14,220,,33016,,1369469,,,,
85,Upper Cover Unique,84,40,3360,,,01-03-14,221,,56376,,1425845,,,,
86,Upper Cover Window,74,40,2960,,,01-07-14,222,,68380,,1494225,,,,
87,Dial Blank 70,1000,9,9000,,,01-09-14,223,,73818,,1568043,,,,
88,Upper Cover Window,514,40,20560,,,01-10-14,224,,75460,,1643503,,,,
89,,,,57080,,,01-13-14,225,,84552,,1728055,,,,
90,Upper Cover Window,583,40,23320,08-30-12,,01-16-14,226,,124974,,1853029,,,,
91,Back Cover 70,569,32,18208,,,01-17-14,,Cheque HBL,,300000,1553029,,,,
92,Housing 70 Black,597,9,5373,,,01-17-14,227,,48275,,1601304,,,,
93,,,,46901,,,01-22-14,,Cheque Received,,400000,1201304,,,,
94,Dial Blank 70,2000,9,18000,09-01-12,,01-23-14,228,,29644,,1230948,,,,
95,Upper Cover Window,538,40,21520,,,01-24-14,229,,32622,,1263570,,,,
96,Back Cover 70,612,32,19584,,,01-27-14,230,,90845,,1354415,,,,
97,Housing 70 Black,446,9,4014,,,01-29-14,231,,88162,,1442577,,,,
98,,,,63118,,,01-30-14,232,,20736,,1463313,,,,
99,Upper Cover Window,522,40,20880,09-03-12,,01-31-14,233,,41688,,1505001,,,,
100,Back Cover 70,555,32,17760,,,02-01-14,234,,56162,,1561163,,,,
101,Housing 70 Black,580,9,5220,,,02-03-14,235,,42352,,1603515,,,,
102,,,,43860,,,02-05-14,236,,18495,,1622010,,,,
103,Upper Cover 70,518,40,20720,09-05-12,,02-06-14,237,,33795,,1655805,,,,
104,Upper Cover Window,288,40,11520,,,02-08-14,238,,43338,,1699143,,,,
105,Back Cover 70,843,32,26976,,,02-11-14,239,,94896,,1794039,,,,
106,Housing 70 Black,684,9,6156,,,02-13-14,240,,65496,,1859535,,,,
107,,,,65372,,,02-17-14,,cheque Received,,375000,1484535,,,,
108,Upper Cover Window,581,40,23240,09-06-12,,02-17-14,241,,73557,,1558092,,,,
109,Back Cover 70,378,32,12096,,,02-20-14,,Cheque Received,,500000,1058092,,,,
110,,,,35336,,,02-21-14,242,,123684,,1181776,,,,
111,Dial Blank 70,2000,9,18000,09-10-12,,02-22-14,243,,64272,,1246048,,,,=
112,Upper Cover Window,444,40,17760,,,02-26-14,244,,77105,,1323153,,,,
113,Back Cover 70,354,32,11328,,,02-27-14,245,,56810,,1379963,,,,
114,Housing 70 Black,1054,9,9486,,,02-28-14,246,,75468,,1455431,,,,
115,,,,56574,,,03-03-14,247,,79530,,1534961,,,,
116,Upper Cover Window,480,40,19200,09-14-12,,03-04-14,248,,60306,,1595267,,,,
117,Back Cover 70,607,32,19424,,,03-11-14,249,,79710,,1674977,,,,
118,Housing 70 Black,554,9,4986,,,03-12-14,250,,77736,,1752713,,,,
119,,,,43610,,,03-14-14,,Cheq# 1701118 Burj bank,,400000,1352713,,,,
120,Upper Cover Window,397,40,15880,09-17-12,,03-17-14,251,,74271,,1426984,,,,
121,Back Cover 70,494,32,15808,,,03-19-14,,REJECTION,,14706,1412278,,,,
122,Housing 70 Black,612,9,5508,,,03-19-14,252,,63714,,1475992,,,,
123,,,,37196,,,03-20-14,0,,73458,,1549450,,gp,,
124,Upper Cover Window,523,40,20920,09-20-12,,03-24-14,,Cheq# 01714454 Burjbank,,400000,1149450,,,,
125,Back Cover 70,523,32,16736,,,03-29-14,253,,123265,,1272715,,,,
126,Housing 70 Black,578,9,5202,,,04-01-14,254,,76176,,1348891,,,,
127,,,,42858,,,04-05-14,255,,85016,,1433907,,,,
128,Upper Cover Window,518,40,20720,09-24-12,,04-10-14,256,,78784,,1512691,,,,
129,Back Cover 70,502,32,16064,,,04-17-14,,,,600000,912691,,,,
130,Housing 70 Black,500,9,4500,,,,,,,30000,882691,,,,
131,,,,41284,,,21-04-14,257,,48234,,930925,,,,
132,Dial Blank 70,700,9,6300,09-26-12,,04-21-14,,burj,,300000,630925,,,,
133,Upper Cover Qinque ,514,45,23130,,,24-04-14,258,,75426,,706351,,,,
134,Back Cover Qinque,510,20,10200,,,28-04-14,259,,69434,,775785,,,,
135,Housing Qinque,518,35,18130,,,30-04-14,260,,112690,,888475,,,,
136,Nest Qinque,510,20,10200,,,07-05-14,261,,51804,,940279,,,,
137,,,,67960,,,08-05-14,262,,16498,,956777,,,,
138,Dial Blank 70,1000,9,9000,09-27-12,,09-05-14,263,,22896,,979673,,,,
139,Upper Cover 70,166,40,6640,,,10-05-14,264,,22896,,1002569,,,,
140,Upper Cover Window,361,40,14440,,,12-05-14,265,,35808,,1038377,,,,
141,Back Cover 70,658,32,21056,,,13-05-14,266,,52056,,1090433,,,,
142,Housing 70 Black,588,9,5292,,,14-05-14,267,,8000,,1098433,,,,
143,,,,56428,,,15-05-14,268,,48888,,1147321,,,,
144,Upper Cover Window,892,40,35680,10-01-12,,16-05-14,269,,46908,,1194229,,,,
145,Back Cover 70,321,32,10272,,,14-05-14,,Chequeburj,,300000,894229,,,,
146,Housing 70 Black,478,9,4302,,,16-05-14,,Cash Received,,133000,761229,,,,
147,Dial blank 70,2000,9,18000,,,20-05-14,270,,53912,,815141,,,,
148,,,,68254,,,23-05-14,271,,55230,,870371,,,,
149,Upper Cover Window,740,40,29600,10-05-12,,24-05-14,272,,32220,,902591,,,,
150,Back Cover 70,480,32,15360,,,27-05-14,274,,42672,,945263,,,,
151,Housing 70 Black,559,9,5031,,,29-05-14,275,,128810,,987935,,,,
152,,,,49991,,,30-05-14,276,,47232,,1116745,,,,
153,Upper Cover Window,812,40,32480,10-08-12,,31-05-14,277,,39342,,1163977,705172,May,,
154,Back Cover 70,796,32,25472,,,02-06-14,278,,36078,,1203319,,,,
155,Housing 70 Black,797,9,7173,,,04-06-14,279,,58954,,1239397,,,,
156,,,,65125,,,05-06-14,280,,35496,,1298351,,,,
157,Upper Cover Qinque ,500,45,22500,10-11-12,,10-06-14,281,,57624,,1333847,,,,
158,Back cover Qinque,500,20,10000,,,13-06-14,282,,35600,,1391471,,,,
159,Housing Qinque,500,35,17500,,,14-06-14,,Cash Received burj bank,,670000,757071,,,,
160,Nest Qinque,500,20,10000,,,17-06-14,283,,80646,,837717,,,,
161,,,,60000,,,20-06-14,284,,73746,,911463,,,,
162,Upper Cover window,753,40,30120,10-13-12,,23-06-14,285,,35964,,947427,,,,
163,back Cover 70,743,32,23776,,,06-25-14,286,,28494,,975921,,,,
164,Housing 70 black,737,9,6633,,,26-06-14,287,,45060,,1020981,,,,
165,Dial blank qinque,25,12,300,,,27-06-14,288,,61198,,1082179,,,,
166,,,,60829,,,28-06-14,289,,81210,,1163389,630070,june,,
167,Upper Cover Window,444,40,17760,09-09-12,,01-07-14,290,,46454,,1209843,,,,
168,Back Cover 70,612,32,19584,,,02-07-14,291,,66616,,1276459,,,,
169,Housing 70 Black,482,9,4338,,,03-07-14,292,,120135,,1396594,,,,
170,,,,41682,,,04-07-14,293,,46988,,1443582,,,,
171,Dial Blank Qinque,1000,12,12000,10-17-12,,08-07-14,294,,34914,,1478496,,,,
172,dial Blank 70,600,9,5400,,,09-07-14,295,,46290,,1524786,,,,
173,Upper Cover Window,520,40,20800,,,10-07-14,296,,69504,,1594290,,,,
174,Back Cover 70,531,32,16992,,,17-07-14,297,,73336,,1667626,,,,
175,Housing 70 Black,560,9,5040,,,18-07-14,298,,75860,,1743486,,,,
176,,,,60232,,,17-07-14,,Cash Received,,600000,1143486,,,,
177,Dial Blank 70,2000,9,18000,10-24-12,,21-07-14,299,,3384,,1146870,,,,
178,Upper Cover Window,829,40,33160,,,27-07-14,300,,78078,,1224948,661559,july,,
179,Back Cover 70,801,32,25632,,,06-08-14,301,,76264,,1301212,,,,
180,Housing 70 Black,636,9,5724,,,16-08-14,08-08-14,H B L    1912374,,90000,1211212,,,,
181,,,,82516,,,09-08-14,302,,110410,,1321622,,,,
182,Upper Cover Window,695,40,27800,10-25-12,,12-08-14,303,,65310,,1386932,,,,
183,Back Cover 70,622,32,19904,,,12-08-14,304,,12000,,1398932,,,,
184,Housing 70 Black,640,9,5760,,,13-08-14,305,,86394,,1485326,,,,
185,,,,53464,,,15-08-14,306,,65328,,1550654,,,,
186,Upper Cover Window,563,40,22520,11-01-12,,19-08-14,18-08-14,burj bank,,660000,890654,,,,
187,Back Cover 70,537,32,17184,,,22-08-14,307,,49844,,940498,,,,
188,Housing 70 Black,545,9,4905,,,23-08-14,308,,26844,,967342,,,,
189,Dial Blank 70,2000,9,18000,,,27-08-14,309,,56046,,1023388,,,,
190,,,,62609,,,26-08-14,310,,37320,,1060708,,,,
191,Dial Blank 70,1000,9,9000,11-05-12,,28-08-14,311,,60126,,1120834,,,,
192,dial Blank Qinque,1000,12,12000,,,29-08-14,312,,12000,,1132834,657886,Aug,,
193,Upper Cover Window,823,40,32920,,,02-09-14,313,,61750,,1194584,,,,
194,Back Cover 70,769,32,24608,,,04-09-14,314,,127900,,1322484,,,,
195,Housing 70 Black,700,9,6300,,,06-09-14,315,,33264,,1355748,,,,
196,,,,84828,,,10-09-14,316,,62855,,1418603,,,,
197,Upper Cover Qinque ,506,45,22770,11-07-12,,11-09-14,317,,37480,,1456083,,,,
198,Housing Qinque,506,35,17710,,,13-09-14,318,,42068,,1498151,,,,
199,Back Cover Qinque,506,20,10120,,,17-09-14,16-09-14,burj bank 01714519,,645000,853151,,,,
200,Nest Qinque,506,20,10120,,,16-09-14,319,,42860,,896011,,,,
201,,,,60720,,,17-09-14,320,,66892,,962903,,,,
202,Upper cover window,821,40,32840,11-07-12,,18-09-14,321,,10680,,973583,,,,
203,back Cover 70,834,32,26688,,,29-09-14,322,,68591,,1042174,554340,Sep,,
204,Housing 70,820,9,7380,,,01-10-14,323,,73070,,1115244,,,,
205,,,,66908,,,02-10-14,324,,27585,,1142829,,,,
206,Upper cover window,760,40,30400,11-12-12,,03-10-14,325,,37083,,1179912,,,,
207,back Cover 70,512,32,16384,,,09-10-14,326,,57528,,1237440,,,,
208,Housing 70,502,9,4518,,,10-10-14,327,,42226,,1279666,,,,
209,,,,51302,,,14-10-14,328,,71470,,1351136,,,,
210,Upper Cover Window,472,40,18880,11-14-12,,15-10-14,329,,47135,,1398271,,,,
211,Back Cover 70,437,32,13984,,,17-10-14,17-10-14,burj bank 01714544,,485000,913271,,,,
212,Housing 70 Black,448,9,4032,,,18-10-14,330,,122250,,1035521,,,,
213,upper Cover Sohrab js,100,45,4500,,,16-10-14,331,,76810,,1112331,,,,
214,back cover sohrab js,100,20,2000,,,20-10-14,332,,44393,,1156724,,,,
215,Housing sohrab js,100,35,3500,,,21-10-14,333,,52275,,1208999,,,,
216,Nest sohrab js,100,20,2000,,,22-10-14,334,,23770,,1232769,,,,
217,,,,48896,,,27-10-14,335,,31890,,1264659,,,,
218,Dial Blank 70,1000,9,9000,11-19-12,,23-10-14,336,,19710,,1284369,,,,
219,Upper Cover window,1022,40,40880,,,30-10-14,337,,6600,,1290969,,,,
220,Back Cover 70,555,32,17760,,,31-10-14,338,,92845,,1383814,826640,oct,,
221,Housing 70 Black,1108,9,9972,,,01-11-14,339,,15020,,1398834,,,,
222,,,,77612,,,05-11-14,340,,46130,,1444964,,,,
223,Dial Blank 70,2000,9,18000,11-26-12,,06-11-14,341,,33519,,1478483,,,,
224,Upper Cover window,1004,40,40160, ,,07-11-14,342,,54594,,1533077,,,,
225,Back Cover 70,920,32,29440,,,08-11-14,343,,67170,,1600247,,,,
226,Housing 70 Black,168,9,1512,,,11-10-14,344,,56570,,1656817,,,,
227,,,,89112,,,11-11-14,345,,36231,,1693048,,,,
228,Dial Blank 70,2000,9,18000,11-29-12,,13-11-14,346,,39378,,1732426,,,,
229,Upper Cover window,563,40,22520,,,15-11-14,347,,60357,,1792783,,,,
230,Back Cover 70,555,32,17760,,,17-11-14,348,,30170,,1822953,,,,
231,Housing 70 Black,1578,9,14202,,,15-11-14,,    burj bank  01723082,,730000,1092953,,,,
232,,,,72482,,,18-11-14,349,,36866,,1129819,,,,
233,Upper Cover window,622,40,24880,12-01-12,,18-11-14,350,,87195,,1217014,,,,
234,Back Cover 70,738,32,23616,,,22-11-14,351,,66958,,1283972,,,,
235,Housing 70 Black,567,9,5103,,,25-11-14,352,,26160,,1310132,,,,
236,,,,53599,,,28-11-14,353,,97786,,1407918,,,,
237,Upper Cover window,458,40,18320,12-03-12,,01-12-14,354,,25555,,1433473,,, ,
238,Back Cover 70,503,32,16096,,,02-12-14,355,,41160,,1474633,,,,
239,Housing 70 Black,577,9,5193,,,03-12-14,356,,98075,,1572708,,,,
240,,,,39609,,,04-12-14,357,,24110,,1596818,,,,
241,Upper Cover window,1008,40,40320,12-05-12,,05-12-14,358,,45995,,1642813,,,,
242,Back Cover 70,510,32,16320,,,06-12-14,359,,32670,,1675483,,,,
243,Housing 70 Black,612,9,5508,,,06-12-14,360,,6435,,1681918,,,,
244,,,,62148,,,08-12-14,361,,64402,,1746320,,,,
245,Dial Blank 70,1500,9,13500,12-08-12,,11-12-14,362,,72450,,1818770,,,,
246,Upper Cover Qinque ,288,45,12960,,,12-12-14,363,,36330,,1855100,,,,
247,housing Qinque,288,35,10080,,,15-12-14,364,,46775,,1901875,,,,
248,Back cover qinque,288,20,5760,,,16-12-14,365,,47650,,1949525,,,,
249,Nest Qinque,288,20,5760,,,18-12-14,,Burj bank,,817000,1132525,,,,
250,Back Cover 70,716,32,22912,,,18-12-14,366,,40600,,1173125,,,,
251,Housing 70 Black,741,9,6669,,,20-12-14,367,,54506,,1227631,,,,
252,,,,77641,,,23-12-14,368,,72685,,1300316,,,,
253,Upper Cover window,1058,40,42320,12-10-12,,24-12-14,369,,33872,,1334188,,,,
254,Back Cover 70,306,32,9792,,,26-12-14,370,,24748,,1358936,,,,
255,Housing 70 Black,1038,9,9342,,,29-12-14,371,,36380,,1395316,,,,
256,,,,61454,,,29-12-14,372,,79335,,1474651,,,,
257,Upper Cover window,896,40,35840,12-12-12,,30-12-14,373,,35070,,1509721,,,,
258,Back Cover 70,849,32,27168,,,31-12-14,374,,115835,,1625556,1034638,,,
259,Housing 70 Black,881,9,7929,,,02-01-15,375,,85354,,1710910,,,,
260,,,,70937,,,03-01-15,376,,42730,,1753640,,,,
261,Upper Cover window,515,40,20600,12-15-12,,05-01-15,377,,37902,,1791542,,,,
262,Back Cover 70,519,32,16608,,,07-01-15,378,,48615,,1840157,,,,
263,Housing 70 Black,525,9,4725,,,09-01-15,379,,64680,,1904837,,,,
264,,,,41933,,,12-01-15,380,,14385,,1919222,,,,
265,Upper Cover Qinque ,504,45,22680,12-17-12,,13-01-15,381,,39030,,1958252,,,,
266,back cover Qinque,500,20,10000,,,14-01-15,382,,59290,,2017542,,,,
267,Housing Qinque,500,35,17500,,,15-01-15,383,,36000,,2053542,,,,
268,Nest Qinque,500,20,10000,,,15-01-15,384,,28390,,2081932,,,,
269,,,,60180,,,17-01-15,385,,69436,,2151368,,,,
270,Dial Blank 70,3000,8,24000,12-22-12,,16-01-15,,burj bank,,900000,1251368,,,,
271,Upper cover Window,376,40,15040,,,19-01-15,386,,21655,,1273023,,,,
272,Back Cover 70,900,30,27000,,,22-01-15,387,,45765,,1318788,,,,
273,Hoiusing 70,305,9,2745,,,23-01-15,388,,7700,,1326488,,,,
274,,,,68785,,,,,,,,,,,,
275,Upper cover Window,767,40,30680,12-27-12,,,,,,,,,,,
276,Back Cover 70,1053,30,31590,,,,,,,,,,,,
277,Hoiusing 70,686,9,6174,,,,,,,,,,,,
278,,,,68444,,,,,,,,,,,,
279,Upper Cover Window,703,40,28120,12-29-12,,,,,,,,,,,
280,Back Cover 70,703,30,21090,,,,,,,,,,,,
281,Hoiusing 70,703,9,6327,,,,,,,,,,,,
282,,,,55537,,,,,,,,,,,,
283,Upper Cover Window,473,40,18920,01-02-13,,,,,,,,,,,
284,Back Cover 70,1031,30,30930,,,,,,,,,,,,
285,Hoiusing 70,1068,8,8544,,,,,,,,,,,,
286,Dial Blank 70,3000,8,24000,,,,,,,,,,,,
287,Dial Blank Qinque,1000,12,12000,,,,,,,,,,,,
288,,,,94394,,,,,,,,,,,,
289,Upper Cover Window,537,40,21480,01-03-13,,,,,,,,,,,
290,Upper Cover Window,528,40,21120,,,,,,,,,,,,
291,Back Cover 70,525,30,15750,,,,,,,,,,,,
292,Housing 70 Black,524,8,4192,,,,,,,,,,,,
293,,,,62542,,,,,,,,,,,,
294,Upper Cover Window,526,40,21040,01-05-12,,,,,,,,,,,
295,Back Cover 70,504,30,15120,,,,,,,,,,,,
296,Hoiusing 70 Black,587,8,4696,,,,,,,,,,,,
297,Back Cover Qinque Replace,500,,0,,,,,,,,,,,,
298,,,,40856,,,,,,,,,,,,
299,Upper Cover Window,543,40,21720,01-08-13,,,,,,,,,,,
300,Upper Cover Window,232,40,9280,,,,,,,,,,,,
301,Back Cover 70,838,30,25140,,,,,,,,,,,,
302,Housing 70 Black,846,8,6768,,,,,,,,,,,,
303,,,,62908,,,,,,,,,,,,
304,Upper Cover Qinque ,522,45,23490,01-12-13,,,,,,,,,,,
305,Back cover Qinque,940,20,18800,,,,,,,,,,,,
306,Housing Qinque,944,35,33040,,,,,,,,,,,,
307,Nest Qinque,940,20,18800,,,,,,,,,,,,
308,,,,94130,,,,,,,,,,,,
309,Dial Blank 70,500,8,4000,01-16-13,,,,,,,,,,,
310,Upper Cover Window,1011,40,40440,,,,,,,,,,,,
311,Back Cover 70,1033,30,30990,,,,,,,,,,,,
312,,,,75430,,,,,,,,,,,,
313,Dial Blank 70,3000,8,24000,01-24-13,,,,,,,,,,,
314,Upper cover qinque,1002,45,45090,,,,,,,,,,,,
315,back Cover qinque,1010,20,20200,,,,,,,,,,,,
316,Nest qinque,1000,20,20000,,,,,,,,,,,,
317,Upper Cover Sohrab Js,203,45,9135,,,,,,,,,,,,
318,,,,118425,,,,,,,,,,,,
319,Dial Blank Qinque,1300,12,15600,01-28-13,,,,,,,,,,,
320,Upper Cover Window,1008,40,40320,,,,,,,,,,,,
321,Back Cover 70,1044,30,31320,,,,,,,,,,,,
322,Housing 70 Black,1086,8,8688,,,,,,,,,,,,
323,Back Cover 70,519,30,15570,,,,,,,,,,,,
324,Housing 70 Black,588,8,4704,,,,,,,,,,,,
325,Housing qinque,464,35,16240,,,,,,,,,,,,
326,,,,132442,,,,,,,,,,,,
327,Upper Cover Window,472,40,18880,01-29-13,,,,,,,,,,,
328,Housing Qinque,540,35,18900,,,,,,,,,,,,
329,Back Cover Qinque Replace,540,,0,,,,,,,,,,,,
330,,,,37780,,,,,,,,,,,,
331,Dial Blank 70,2000,8,16000,02-04-13,,,,,,,,,,,
332,Upper Cover Window,854,40,34160,,,,,,,,,,,,
333,Back Cover 70,839,30,25170,,,,,,,,,,,,
334,Hoiusing 70 Black,840,8,6720,,,,,,,,,,,,
335,,,,82050,,,,,,,,,,,,
336,Upper Cover Window,848,40,33920,02-09-13,,,,,,,,,,,
337,Back Cover 70,821,30,24630,,,,,,,,,,,,
338,Hoiusing 70 Black,893,8,7144,,,,,,,,,,,,
339,,,,65694,,,,,,,,,,,,
340,Upper Cover Window,300,40,12000,02-14-13,,,,,,,,,,,
341,Back Cover 70,333,30,9990,,,,,,,,,,,,
342,Hoiusing 70 Black,348,8,2784,,,,,,,,,,,,
343,Housing Qinque,503,35,17605,,,,,,,,,,,,
344,back cover qinque,500,20,10000,,,,,,,,,,,,
345,,,,52379,,,,,,,,,,,,
346,Upper Cover Window,703,40,28120,02-19-13,,,,,,,,,,,
347,Back Cover 70,1020,30,30600,,,,,,,,,,,,
348,Housing 70 Black,1230,8,9840,,,,,,,,,,,,
349,,,,68560,,,,,,,,,,,,
350,Upper Cover Window,894,40,35760,02-20-13,,,,,,,,,,,
351,Back Cover 70,918,30,27540,,,,,,,,,,,,
352,Housing 70 Black,480,8,3840,,,,,,,,,,,,
353,,,,67140,,,,,,,,,,,,
354,Upper Cover Window,444,40,17760,02-22-13,,,,,,,,,,,
355,Back Cover 70,306,30,9180,,,,,,,,,,,,
356,Hoiusing 70 Black,304,8,2432,,,,,,,,,,,,
357,,,,29372,,,,,,,,,,,,
358,Upper cover qinque ,972,45,43740,02-26-13,,,,,,,,,,,
360,Housing Qinque,914,35,31990,,,,,,,,,,,,
361,Nest Qinque,918,20,18360,,,,,,,,,,,,
362,Back Cover qinque,935,20,18700,,,,,,,,,,,,
363,Upper Cover Window,876,40,35040,,,,,,,,,,,,
364,Back Cover 70,408,30,12240,,,,,,,,,,,,
365,,,,160070,,,,,,,,,,,,
366,Dial Blank 70,1600,8,12800,03-02-13,,,,,,,,,,,
367,Upper Cover Window,1058,40,42320,,,,,,,,,,,,
368,Back Cover 70,519,30,15570,,,,,,,,,,,,
369,Hoiusing 70 black,540,8,4320,,,,,,,,,,,,
370,,,,75010,,,,,,,,,,,,
371,Dial Blank ainque,1000,12,12000,03-26-13,,,,,,,,,,,
372,Upper Cover Qinque ,110,45,4950,,,,,,,,,,,,
373,Back Cover Qinque,120,20,2400,,,,,,,,,,,,
374,Dial Blank Qinque,1000,12,12000,,,,,,,,,,,,
375,Upper Cover Qinque ,92,45,4140,,,,,,,,,,,,
376,Housing qinque,441,35,15435,,,,,,,,,,,,
377,nest Qinque,500,20,10000,,,,,,,,,,,,
378,,,,60925,,,,,,,,,,,,
379,Dial Blank 70,1500,8,12000,03-29-13,,,,,,,,,,,
380,upper Cover Sohrab Js ,316,45,14220,,,,,,,,,,,,
381,Housing Sohrab js,290,35,10150,,,,,,,,,,,,
382,back Cover Sohrab js,300,20,6000,,,,,,,,,,,,
383,Nest Red,300,20,6000,,,,,,,,,,,,
384,Housing qinque,596,35,20860,,,,,,,,,,,,
385,Back Cover qinque,1005,20,20100,,,,,,,,,,,,
386,nest Qinque,1000,20,20000,,,,,,,,,,,,
387,,,,109330,,,,,,,,,,,,
388,Upper Cover Qinque ,390,45,17550,03-30-13,,,,,,,,,,,
389,Dial blank qinque,300,12,3600,,,,,,,,,,,,
390,,,,21150,,,,,,,,,,,,
391,Upper cover Qinque ,672,45,30240,04-01-13,,,,,,,,,,,
392,back Cover qinque,500,20,10000,,,,,,,,,,,,
393,Nest Qinque,500,20,10000,,,,,,,,,,,,
394,,,,50240,,,,,,,,,,,,
395,Upper cover Qinque ,406,45,18270,04-02-13,,,,,,,,,,,
396,Back Cover 70,552,30,16560,,,,,,,,,,,,
397,Hoiusing 70 Black,534,8,4272,,,,,,,,,,,,
398,Dial Blank 70,600,8,4800,,,,,,,,,,,,
399,,,,43902,,,,,,,,,,,,
400,Upper cover zxmco,832,40,33280,04-04-13,,,,,,,,,,,
401,Upper Cover Window,434,40,17360,04-06-13,,,,,,,,,,,
402,Housing qinque,224,35,7840,,,,,,,,,,,,
403,,,,25200,,,,,,,,,,,,
404,Dial Blank 70,950,8,7600,,,,,,,,,,,,
405,Back Cover 70,102,30,3060,,,,,,,,,,,,
406,Housing 70 Black,447,8,3576,,,,,,,,,,,,
407,,,,14236,,,,,,,,,,,,
408,Upper Cover Window,282,40,11280,04-15-13,,,,,,,,,,,
409,Back Cover 70,464,30,13920,,,,,,,,,,,,
410,Hoiusing 70,360,8,2880,,,,,,,,,,,,
411,,,,28080,,,,,,,,,,,,
412,Back Cover 70,444,40,17760,04-17-13,,,,,,,,,,,
413,Housing 70,376,8,3008,,,,,,,,,,,,
414,Housing Qinque,458,35,16030,,,,,,,,,,,,
415,,,,36798,,,,,,,,,,,,
416,Dial Blank 70,900,8,7200,04-23-13,,,,,,,,,,,
417,Dial Blank Qinque,560,12,6720,,,,,,,,,,,,
418,Upper cover Qinque ,528,45,23760,,,,,,,,,,,,
419,Nest Qinque,520,20,10400,,,,,,,,,,,,
420,back Cover qinque,1000,20,20000,,,,,,,,,,,,
421,Housing Qinque,784,35,27440,,,,,,,,,,,,
422,Upper Cover Window,338,40,13520,,,,,,,,,,,,
423,,,,109040,,,,,,,,,,,,
424,Upper Cover Window,192,40,7680,04-25-13,,,,,,,,,,,
425,Upper Cover qinque ,424,45,19080,,,,,,,,,,,,
426,Housing qinque,133,35,4655,,,,,,,,,,,,
427,Back Cover 70,592,30,17760,,,,,,,,,,,,
428,Housing 70 Black,713,8,5704,,,,,,,,,,,,
429,Upper Cover Window,90,,0,,,,,,,,,,,,
430,,,,54879,,,,,,,,,,,,
431,Upper Cover Window,263,40,10520,04-29-13,,,,,,,,,,,
432,Back Cover 70,570,30,17100,,,,,,,,,,,,
433,Housing 70 Black,684,8,5472,,,,,,,,,,,,
434,,,,33092,,,,,,,,,,,,
435,Dial Blank qinque,840,12,10080,05-02-13,,,,,,,,,,,
436,Dial Blank 70,2500,8,20000,,,,,,,,,,,,
437,Dial Blank qinque,160,12,1920,,,,,,,,,,,,
438,,,,32000,,,,,,,,,,,,
439,Back Cover 70,602,40,24080,05-04-13,,,,,,,,,,,
440,Housing 70 Black,676,8,5408,,,,,,,,,,,,
441,,,,29488,,,,,,,,,,,,
442,Upper Cover Window,386,40,15440,05-06-13,,,,,,,,,,,
443,Dial Blank 70,1100,8,8800,05-07-13,,,,,,,,,,,
444,Back Cover 70,1029,40,41160,,,,,,,,,,,,
445,,,,49960,,,,,,,,,,,,
446,Upper Cover Window,376,40,15040,05-08-13,,,,,,,,,,,
447,Housing 70 Black,1030,8,8240,,,,,,,,,,,,
448,Upper Cover Window,167,40,6680,,,,,,,,,,,,
449,,,,29960,,,,,,,,,,,,
450,Upper Cover Window,94,40,3760,05-13-13,,,,,,,,,,,
451,Upper Cover Window,188,40,7520,,,,,,,,,,,,
452,Upper Cover Window,188,40,7520,,,,,,,,,,,,
453,Upper Cover Window,888,40,35520,,,,,,,,,,,,
454,Back Cover 70,675,30,20250,,,,,,,,,,,,
455,Housing 70 Black,807,8,6456,,,,,,,,,,,,
456,,,,81026,,,,,,,,,,,,
457,Upper Cover zxmco,852,40,34080,05-13-13,,,,,,,,,,,
458,Back Cover 70,600,30,18000,,,,,,,,,,,,
459,Housing 70 Black,920,8,7360,,,,,,,,,,,,
460,,,,59440,,,,,,,,,,,,
461,Dial Blank 70,500,8,4000,05-17-13,,,,,,,,,,,
462,Upper cover Window,6,40,240,,,,,,,,,,,,
463,Upper cover Window,284,40,11360,,,,,,,,,,,,
464,Back Cover 70,426,30,12780,,,,,,,,,,,,
465,Housing 70 Black,557,8,4456,,,,,,,,,,,,
466,,,,32836,,,,,,,,,,,,
467,Upper Cover window,376,40,15040,05-21-13,,,,,,,,,,,
468,back Cover 70,398,30,11940,,,,,,,,,,,,
469,,,,26980,,,,,,,,,,,,
470,Upper Cover window,553,40,22120,05-22-13,,,,,,,,,,,
471,Upper cover 70 New,233,40,9320,,,,,,,,,,,,
472,Back Cover 70,504,30,15120,,,,,,,,,,,,
473,Housing 70 Black,507,8,4056,,,,,,,,,,,,
474,,,,50616,,,,,,,,,,,,
475,Dial Blank 70,1100,8,8800,05-24-13,,,,,,,,,,,
476,Upper Cover 70 New,364,40,14560,,,,,,,,,,,,
477,back Cover 70,296,30,8880,,,,,,,,,,,,
478,Housing 70 Black,351,8,2808,,,,,,,,,,,,
479,,,,35048,,,,,,,,,,,,
480,Back Cover 70,586,30,17580,05-27-13,,,,,,,,,,,
481,Dial Blank 70,3000,8,24000,05-28-13,,,,,,,,,,,
482,Upper Cover 70 New,480,40,19200,05-29-13,,,,,,,,,,,
483,Back Cover 70,621,30,18630,,,,,,,,,,,,
484,,,,37830,,,,,,,,,,,,
485,Back Cover 70,858,40,34320,05-30-13,,,,,,,,,,,
486,Upper cover window,470,40,18800,05-31-13,,,,,,,,,,,
487,Back Cover 70,902,30,27060,,,,,,,,,,,,
488,Housing 70 black,930,8,7440,,,,,,,,,,,,
489,,,,53300,,,,,,,,,,,,
490,Upper cover window,504,40,20160,06-03-13,,,,,,,,,,,
491,Back Cover 70,828,30,24840,,,,,,,,,,,,
492,Hoiusing 70 Black,210,8,1680,,,,,,,,,,,,
493,,,,46680,,,,,,,,,,,,
494,Upper Cover window,490,40,19600,06-01-13,,,,,,,,,,,
495,Back Cover 70,750,30,22500,,,,,,,,,,,,
496,Housing 70 black,390,8,3120,,,,,,,,,,,,
497,,,,45220,,,,,,,,,,,,
498,Dial Blank 70,3000,8,24000,06-03-13,,,,,,,,,,,
499,upper Cover Window,345,40,13800,06-04-13,,,,,,,,,,,
500,back Cover 70,426,30,12780,,,,,,,,,,,,
501,Housing 70,420,8,3360,,,,,,,,,,,,
502,,,,29940,,,,,,,,,,,,
503,upper Cover Window,304,40,12160,06-05-13,,,,,,,,,,,
504,Upper Cover window,392,40,15680,,,,,,,,,,,,
505,Back Cover 70,324,30,9720,,,,,,,,,,,,
506,Hoiusing 70 Black,1120,8,8960,,,,,,,,,,,,
507,,,,46520,,,,,,,,,,,,
508,Upper Cover window,547,40,21880,06-06-13,,,,,,,,,,,
509,Back Cover 70,620,30,18600,,,,,,,,,,,,
510,Housing 70 Black,560,8,4480,,,,,,,,,,,,
511,,,,44960,,,,,,,,,,,,
512,upper Cover Window,451,40,18040,06-07-13,,,,,,,,,,,
513,Housing 70 Black,1100,8,8800,,,,,,,,,,,,
514,Upper cover Window,83,40,3320,,,,,,,,,,,,
515,,,,30160,,,,,,,,,,,,
516,Upper Cover window,375,40,15000,06-10-13,,,,,,,,,,,
517,dial Blank 70,2000,8,16000,,,,,,,,,,,,
518,Upper Cover window,208,40,8320,,,,,,,,,,,,
519,,,,39320,,,,,,,,,,,,
520,Upper cover Window,490,40,19600,06-11-13,,,,,,,,,,,
521,Back Cover 70,494,30,14820,,,,,,,,,,,,
522,Housing 70 black,612,8,4896,,,,,,,,,,,,
523,,,,39316,,,,,,,,,,,,
524,Upper cover Window,563,40,22520,06-12-13,,,,,,,,,,,
525,Back Cover 70,766,30,22980,,,,,,,,,,,,
526,Housing 70 Black,485,8,3880,,,,,,,,,,,,
527,,,,49380,,,,,,,,,,,,
528,upper Cover window,170,40,6800,06-13-13,,,,,,,,,,,
529,Upper Cover window,451,40,18040,,,,,,,,,,,,
530,Back Cover 70,546,30,16380,,,,,,,,,,,,
531,,,,41220,,,,,,,,,,,,
532,Dial Blank 70,1000,8,8000,06-15-13,,,,,,,,,,,
533,Dial Blank qinque,300,12,3600,,,,,,,,,,,,
534,Upper cover window,376,40,15040,,,,,,,,,,,,
535,,,,26640,,,,,,,,,,,,
536,Upper Cover window,450,40,18000,06-17-13,,,,,,,,,,,
537,Back Cover 70,498,30,14940,,,,,,,,,,,,
538,Housing 70 Black,495,8,3960,,,,,,,,,,,,
539,,,,36900,,,,,,,,,,,,
540,Upper Cover window,547,40,21880,06-19-13,,,,,,,,,,,
541,Back Cover 70,504,30,15120,,,,,,,,,,,,
542,Housing 70 Black,519,8,4152,,,,,,,,,,,,
543,,,,41152,,,,,,,,,,,,
544,Dial Blank 70,500,8,4000,06-20-13,,,,,,,,,,,
545,Upper Cover window,450,40,18000,,,,,,,,,,,,
546,back Cover 70,471,30,14130,,,,,,,,,,,,
547,Housing 70,614,8,4912,,,,,,,,,,,,
548,Upper Cover Sohrab Js,288,45,12960,,,,,,,,,,,,
549,Back cover sohrab js,300,20,6000,,,,,,,,,,,,
550,Nest Sohrab js black,300,20,6000,,,,,,,,,,,,
551,,,,66002,,,,,,,,,,,,
552,Upper Cover window,224,40,8960,06-24-13,,,,,,,,,,,
553,Housing 70 black,980,8,7840,,,,,,,,,,,,
554,Dial Blank 70,1000,8,8000,,,,,,,,,,,,
555,,,,24800,,,,,,,,,,,,
556,Upper Cover window,350,40,14000,06-25-13,,,,,,,,,,,
557,Back Cover 70,496,30,14880,,,,,,,,,,,,
558,Housing 70 Black,510,8,4080,,,,,,,,,,,,
559,,,,32960,,,,,,,,,,,,
560,Back Cover 70,417,30,12510,06-29-13,,,,,,,,,,,
561,Housing 70 Black,544,8,4352,,,,,,,,,,,,
562,,,,16862,,,,,,,,,,,,
563,Dial Blank 70,2500,8,20000,07-01-13,,,,,,,,,,,
564,upper Cover Window,839,40,33560,,,,,,,,,,,,
565,Hoiusing 70 Black,492,8,3936,,,,,,,,,,,,
566,,,,57496,,,,,,,,,,,,
567,Upper Cover window,808,40,32320,07-03-13,,,,,,,,,,,
568,Back Cover 70,791,30,23730,,,,,,,,,,,,
569,Housing 70 Black,765,8,6120,,,,,,,,,,,,
570,,,,62170,,,,,,,,,,,,
571,Cover set unique,5,78,390,07-04-13,,,,,,,,,,,
572,Dial Blank 70,2000,8,16000,,,,,,,,,,,,
573,,,,16390,,,,,,,,,,,,
574,Upper Cover window,958,40,38320,07-05-13,,,,,,,,,,,
575,Back Cover 70,333,30,9990,,,,,,,,,,,,
576,Housing 70 Black,588,8,4704,,,,,,,,,,,,
577,,,,53014,,,,,,,,,,,,
578,Back Cover 70,408,30,12240,07-06-13,,,,,,,,,,,
579,Hoiusing 70 Black,405,8,3240,,,,,,,,,,,,
580,,,,15480,,,,,,,,,,,,
581,Upper Cover Window,316,40,12640,07-09-13,,,,,,,,,,,
582,Upper cover Window,565,40,22600,,,,,,,,,,,,
583,Back Cover 70,585,30,17550,,,,,,,,,,,,
584,,,,52790,,,,,,,,,,,,
585,Upper Cover window,729,40,29160,07-10-13,,,,,,,,,,,
586,Back Cover 70,748,30,22440,,,,,,,,,,,,
587,Housing 70 Black,520,8,4160,,,,,,,,,,,,
588,,,,55760,,,,,,,,,,,,
589,Upper Cover window,813,40,32520,07-11-13,,,,,,,,,,,
590,Back Cover 70,666,30,19980,,,,,,,,,,,,
591,Housing 70 Black,628,8,5024,,,,,,,,,,,,
592,Dial Blank 70,1000,8,8000,,,,,,,,,,,,
593,,,,65524,,,,,,,,,,,,
594,Upper Cover Zxmco,323,40,12920,07-13-13,,,,,,,,,,,
595,Upper Cover window,161,40,6440,,,,,,,,,,,,
596,back Cover 70,606,30,18180,,,,,,,,,,,,
597,,,,37540,,,,,,,,,,,,
598,Back Cover 70,482,30,14460,07-15-13,,,,,,,,,,,
599,Housing 70,363,8,2904,,,,,,,,,,,,
600,,,,17364,,,,,,,,,,,,
601,upper Cover window,478,40,19120,07-16-13,,,,,,,,,,,
602,Back Cover 70,510,30,15300,,,,,,,,,,,,
603,Housing 70,528,8,4224,,,,,,,,,,,,
604,,,,38644,,,,,,,,,,,,
605,upper Cover window,437,40,17480,07-17-13,,,,,,,,,,,
606,Back Cover 70,612,30,18360,,,,,,,,,,,,
607,Housing 70 black,540,8,4320,,,,,,,,,,,,
608,,,,40160,,,,,,,,,,,,
609,Dial Blank 70,1000,8,8000,07-19-13,,,,,,,,,,,
610,upper Cover window,470,40,18800,,,,,,,,,,,,
611,Back Cover 70,573,30,17190,,,,,,,,,,,,
612,Housing 70 black,531,8,4248,,,,,,,,,,,,
613,,,,48238,,,,,,,,,,,,
614,Dial Blank 70,2000,8,16000,07-22-13,,,,,,,,,,,
615,upper Cover window,574,40,22960,,,,,,,,,,,,
616,Back Cover 70,606,30,18180,,,,,,,,,,,,
617,Housing 70 black,180,8,1440,,,,,,,,,,,,
618,,,,58580,,,,,,,,,,,,
619,dial blank qinque,2000,12,24000,07-26-13,,,,,,,,,,,
620,upper Cover Window,292,40,11680,,,,,,,,,,,,
621,Back Cover 70,306,30,9180,,,,,,,,,,,,
622,Housing 70 Black,640,8,5120,,,,,,,,,,,,
623,Housing Qinque,490,35,17150,,,,,,,,,,,,
624,,,,67130,,,,,,,,,,,,
625,Upper Cover window,264,40,10560,07-27-13,,,,,,,,,,,
626,back Cover 70,222,30,6660,,,,,,,,,,,,
627,Upper Cover Qinque ,463,45,20835,,,,,,,,,,,,
628,housing qinque,240,35,8400,,,,,,,,,,,,
629,Back Cover Qinque,230,20,4600,,,,,,,,,,,,
630,Nest Qinque,680,20,13600,,,,,,,,,,,,
631,,,,64655,,,,,,,,,,,,
632,Housing 70 Black,242,8,1936,07-29-13,,,,,,,,,,,
633,Upper Cover window,282,40,11280,,,,,,,,,,,,
634,Upper cover qinque ,422,45,18990,,,,,,,,,,,,
635,Housing Qinque,618,35,21630,,,,,,,,,,,,
636,,,,53836,,,,,,,,,,,,
637,Dial Blank 70,2500,8,20000,07-30-13,,,,,,,,,,,
638,Back cover Qinque,300,20,6000,,,,,,,,,,,,
639,,,,26000,,,,,,,,,,,,
640,back Cover Qinque,200,20,4000,07-31-13,,,,,,,,,,,
641,Housing 70 black,140,8,1120,,,,,,,,,,,,
642,upper Cover Window,390,40,15600,,,,,,,,,,,,
643,Back Cover 70,408,30,12240,,,,,,,,,,,,
644,Housing 70 black,75,8,600,,,,,,,,,,,,
645,,,,33560,,,,,,,,,,,,
646,upper Cover Window,376,40,15040,08-01-13,,,,,,,,,,,
647,Back Cover 70,510,30,15300,,,,,,,,,,,,
648,Housing 70 black,589,8,4712,,,,,,,,,,,,
649,Upper Cover Qinque ,132,45,5940,,,,,,,,,,,,
650,back Cover qinque,220,20,4400,,,,,,,,,,,,
651,Nest Qinque,200,20,4000,,,,,,,,,,,,
652,,,,49392,,,,,,,,,,,,
653,upper Cover Window,400,40,16000,08-03-13,,,,,,,,,,,
654,Back Cover 70,583,30,17490,,,,,,,,,,,,
655,Housing 70 ,510,8,4080,,,,,,,,,,,,
656,,,,37570,,,,,,,,,,,,
657,Upper Cover qinque ,788,45,35460,08-04-13,,,,,,,,,,,
658,Housing qinque,801,35,28035,,,,,,,,,,,,
659,,,,63495,,,,,,,,,,,,
660,Housing 70 black,608,8,4864,08-05-13,,,,,,,,,,,
661,Dial Blank 70,4000,8,32000,,,,,,,,,,,,
662,,,,36864,,,,,,,,,,,,
663,Upper Cover window,376,40,15040,08-06-13,,,,,,,,,,,
664,back Cover 70,825,30,24750,,,,,,,,,,,,
665,Housing 70 black,644,8,5152,,,,,,,,,,,,
666,,,,39790,,,,,,,,,,,,
667,Back Cover 70,612,30,18360,08-15-13,,,,,,,,,,,
668,Housing 70,590,8,4720,,,,,,,,,,,,
669,,,,23080,,,,,,,,,,,,
670,Upper cover Window,657,40,26280,08-16-13,,,,,,,,,,,
671,upper Cover 70,481,40,19240,,,,,,,,,,,,
672,back Cover 70,604,30,18120,,,,,,,,,,,,
673,Housing 70 black,360,8,2880,,,,,,,,,,,,
674,,,,66520,,,,,,,,,,,,
675,Back cover Qinque,300,20,6000,08-17-13,,,,,,,,,,,
676,Upper Cover window,477,40,19080,,,,,,,,,,,,
677,back Cover 70,650,30,19500,,,,,,,,,,,,
678,Housing 70 black,280,8,2240,,,,,,,,,,,,
679,,,,46820,,,,,,,,,,,,
680,Upper Cover window,802,40,32080,08-19-13,,,,,,,,,,,
681,back Cover 70,775,30,23250,,,,,,,,,,,,
682,Housing 70 black,616,8,4928,,,,,,,,,,,,
683,,,,60258,,,,,,,,,,,,
684,Back Cover Qinque ,200,20,4000,08-20-13,,,,,,,,,,,
685,Upper Cover Qinque ,38,45,1710,,,,,,,,,,,,
686,Nest Qinque,100,20,2000,,,,,,,,,,,,
687,Upper Cover Window,472,36,16992,,,,,,,,,,,,
688,Back Cover 70,378,30,11340,,,,,,,,,,,,
689,Housing 70 Black,318,8,2544,,,,,,,,,,,,
690,Upper Cover qinque ,350,45,15750,,,,,,,,,,,,
691,Back Cover Qinque,200,20,4000,,,,,,,,,,,,
692,Nest Qinque,260,20,5200,,,,,,,,,,,,
693,,,,63536,,,,,,,,,,,,
694,Dial blank qinque,2000,12,24000,08-28-13,,,,,,,,,,,
695,Dial Blank 70,2000,8,16000,,,,,,,,,,,,
696,back Cover 70,606,30,18180,,,,,,,,,,,,
697,Housing 70 black,640,8,5120,,,,,,,,,,,,
698,Back cover qinque,500,20,10000,,,,,,,,,,,,
699,nest Qinque,1080,20,21600,,,,,,,,,,,,
700,Housing qinque,203,35,7105,,,,,,,,,,,,
701,,,,102005,,,,,,,,,,,,
702,Upper Cover qinque ,216,45,9720,08-30-13,,,,,,,,,,,
703,upper Cover Zxmco,527,36,18972,,,,,,,,,,,,
704,Back Cover 70,510,30,15300,,,,,,,,,,,,
705,Housing 70 black,630,8,5040,,,,,,,,,,,,
706,,,,49032,,,,,,,,,,,,
707,upper Cover 70 new,666,36,23976,09-02-13,,,,,,,,,,,
708,Upper Cover zxmco,511,36,18396,,,,,,,,,,,,
709,Back Cover 70,870,30,26100,,,,,,,,,,,,
710,Housing 70 black,880,8,7040,,,,,,,,,,,,
711,,,,75512,,,,,,,,,,,,
712,Dial Blank 70,3000,8,24000,09-05-13,,,,,,,,,,,
713,Upper cover window,332,36,11952,,,,,,,,,,,,
714,Housing 70 black,174,8,1392,,,,,,,,,,,,
715,Upper cover Qinque ,300,45,13500,,,,,,,,,,,,
716,Back Cover qinque,1000,20,20000,,,,,,,,,,,,
717,Nest Qinque,680,20,13600,,,,,,,,,,,,
718,,,,84444,,,,,,,,,,,,
719,upper cover qinque ,692,45,31140,09-06-13,,,,,,,,,,,
720,Housing qinque,500,35,17500,,,,,,,,,,,,
721,,,,48640,,,,,,,,,,,,
722,upper cover qinque ,684,45,30780,09-07-13,,,,,,,,,,,
723,Housing qinque,784,35,27440,,,,,,,,,,,,
724,,,,58220,,,,,,,,,,,,
725,Upper Cover 70,507,36,18252,09-09-13,,,,,,,,,,,
726,Housing 70 black,680,8,5440,,,,,,,,,,,,
727,Back cover qinque,300,20,6000,,,,,,,,,,,,
728,Nest Qinque,310,20,6200,,,,,,,,,,,,
729,Housing qinque,314,35,10990,,,,,,,,,,,,
730,,,,46882,,,,,,,,,,,,
731,Upper Cover sohrab Js,312,45,14040,09-10-13,,,,,,,,,,,
732,upper Cover 70,159,36,5724,,,,,,,,,,,,
733,,,,19764,,,,,,,,,,,,
734,upper cover window,711,36,25596,09-13-13,,,,,,,,,,,
735,upper cover window,649,36,23364,09-16-13,,,,,,,,,,,
736,Back Cover 70,844,30,25320,,,,,,,,,,,,
737,Housing 70 Black,460,8,3680,,,,,,,,,,,,
738,,,,52364,,,,,,,,,,,,
739,upper cover window,531,36,19116,09-20-13,,,,,,,,,,,
740,Back Cover 70,534,30,16020,,,,,,,,,,,,
741,Housing 70 Black,705,8,5640,,,,,,,,,,,,
742,,,,40776,,,,,,,,,,,,
743,Back Cover 70,750,30,22500,09-21-13,,,,,,,,,,,
744,Housing 70 Black,280,8,2240,,,,,,,,,,,,
745,,,,24740,,,,,,,,,,,,
746,Dial Blank 70,2500,8,20000,09-23-13,,,,,,,,,,,
747,upper cover window,687,36,24732,,,,,,,,,,,,
748,Back Cover 70,446,30,13380,,,,,,,,,,,,
749,Housing 70 Black,140,8,1120,,,,,,,,,,,,
750,,,,59232,,,,,,,,,,,,
751,dial Blank qinque,2000,12,24000,09-24-13,,,,,,,,,,,
752,upper cover window,687,36,24732,,,,,,,,,,,,
753,Back Cover 70,462,30,13860,,,,,,,,,,,,
754,Housing 70 Black,1056,8,8448,,,,,,,,,,,,
755,,,,71040,,,,,,,,,,,,
756,upper cover window,516,36,18576,10-01-13,,,,,,,,,,,
757,Back Cover 70,512,30,15360,,,,,,,,,,,,
758,Housing 70 Black,645,8,5160,,,,,,,,,,,,
759,Housing qinque,84,35,2940,,,,,,,,,,,,
760,back Cover qinque,900,20,18000,,,,,,,,,,,,
761,Nest Qinque,982,20,19640,,,,,,,,,,,,
762,,,,79676,,,,,,,,,,,,
763,upper cover qinque ,528,45,23760,10-03-13,,,,,,,,,,,
764,Upper Cover 70 New,504,36,18144,,,,,,,,,,,,
765,Upper cover zxmco,538,36,19368,,,,,,,,,,,,
766,Housing 70 Black,1395,8,11160,,,,,,,,,,,,
767,,,,72432,,,,,,,,,,,,
768,Dial Blank 70,3000,8,24000,10-04-13,,,,,,,,,,,
769,Upper Cover Window,493,36,17748,,,,,,,,,,,,
770,Back Cover 70,585,30,17550,,,,,,,,,,,,
771,Housing 70 Black,555,8,4440,,,,,,,,,,,,
772,,,,63738,,,,,,,,,,,,
773,Upper Cover Window,475,36,17100,10-07-13,,,,,,,,,,,
774,Back Cover 70,510,30,15300,,,,,,,,,,,,
775,Housing 70 Black,540,8,4320,,,,,,,,,,,,
776,,,,36720,,,,,,,,,,,,
777,Back Cover 70,546,30,16380,10-08-13,,,,,,,,,,,
778,Housing 70 Black,560,8,4480,,,,,,,,,,,,
779,housing qinque,560,35,19600,,,,,,,,,,,,
780,back cover Qinque,200,20,4000,,,,,,,,,,,,
781,nest Qinque,200,20,4000,,,,,,,,,,,,
782,,,,48460,,,,,,,,,,,,
783,upper Cover sohrab Js,300,45,13500,10-10-13,,,,,,,,,,,
784,Upper Cover Window,170,36,6120,,,,,,,,,,,,
785,Back Cover 70,555,30,16650,,,,,,,,,,,,
786,Housing 70 Black,570,8,4560,,,,,,,,,,,,
787,housing qinque,603,33,19899,,,,,,,,,,,,
788,,,,60729,,,,,,,,,,,,
789,Upper cover qinque ,510,45,22950,10-11-13,,,,,,,,,,,
790,Upper Cover Window,336,36,12096,,,,,,,,,,,,
791,Back Cover 70,435,30,13050,,,,,,,,,,,,
792,Housing 70 Black,540,8,4320,,,,,,,,,,,,
793,,,,52416,,,,,,,,,,,,
794,Upper Cover Window,561,36,20196,10-12-13,,,,,,,,,,,
795,Back Cover 70,350,30,10500,,,,,,,,,,,,
796,Housing 70 Black,360,8,2880,,,,,,,,,,,,
797,,,,33576,,,,,,,,,,,,
798,upper Cover zxmco,814,36,29304,10-14-13,,,,,,,,,,,
799,Upper Cover Window,282,36,10152,10-23-13,,,,,,,,,,,
800,Upper Cover 70 New,148,36,5328,,,,,,,,,,,,
801,Back Cover 70,525,30,15750,,,,,,,,,,,,
802,Housing 70,900,8,7200,,,,,,,,,,,,
803,,,,38430,,,,,,,,,,,,
804,Dial Blank 70,2000,8,16000,10-23-13,,,,,,,,,,,
805,Upper Cover 70 New,376,36,13536,10-24-13,,,,,,,,,,,
806,Back Cover 70,570,30,17100,,,,,,,,,,,,
807,Housing 70,564,8,4512,,,,,,,,,,,,
808,,,,35148,,,,,,,,,,,,
809,Upper Cover Window,705,36,25380,10-25-13,,,,,,,,,,,
810,back Cover qinque,1000,20,20000,,,,,,,,,,,,
811,Housing qinque,1008,35,35280,,,,,,,,,,,,
812,Nest Qinque,1020,20,20400,,,,,,,,,,,,
813,,,,101060,,,,,,,,,,,,
814,Upper Cover Window,526,36,18936,10-28-13,,,,,,,,,,,
815,Back Cover 70,204,30,6120,,,,,,,,,,,,
816,Housing 70 Black,420,8,3360,,,,,,,,,,,,
817,Housing Qinque,428,35,14980,,,,,,,,,,,,
818,back Cover Qinque,510,20,10200,,,,,,,,,,,,
819,Nest Qinque,500,20,10000,,,,,,,,,,,,
820,,,,63596,,,,,,,,,,,,
821,Dial Blank 70,2500,8,20000,10-30-13,,,,,,,,,,,
822,Upper Cover qinque ,1020,45,45900,,,,,,,,,,,,
823,Upper Cover Window,246,36,8856,,,,,,,,,,,,
824,,,,74756,,,,,,,,,,,,
825,Upper Cover Window,510,36,18360,11-02-13,,,,,,,,,,,
826,Back Cover 70,877,30,26310,,,,,,,,,,,,
827,Housing 70 Black,890,8,7120,,,,,,,,,,,,
828,Upper Cover Qinque ,360,45,16200,,,,,,,,,,,,
829,,,,67990,,,,,,,,,,,,
830,dial Blank qinque,500,12,6000,10-31-13,,,,,,,,,,,
831,Upper Cover Window,334,36,12024,11-05-13,,,,,,,,,,,
832,Upper Cover Window,337,36,12132,,,,,,,,,,,,
833,Back Cover 70,265,30,7950,,,,,,,,,,,,
834,Housing 70 Black,1332,8,10656,,,,,,,,,,,,
835,Dial Blank 70,5000,8,40000,,,,,,,,,,,,
836,,,,82762,,,,,,,,,,,,
837,Upper Cover Window,552,36,19872,11-07-13,,,,,,,,,,,
838,Back Cover 70,459,30,13770,,,,,,,,,,,,
839,Housing 70 Black,540,8,4320,,,,,,,,,,,,
840,,,,37962,,,,,,,,,,,,
841,Upper Cover Window,271,36,9756,11-09-13,,,,,,,,,,,
842,Upper Cover Window,592,36,21312,,,,,,,,,,,,
843,Back Cover 70,628,30,18840,,,,,,,,,,,,
844,Housing 70 Black,515,8,4120,,,,,,,,,,,,
845,,,,54028,,,,,,,,,,,,
846,Upper Cover Window,704,36,25344,11-11-13,,,,,,,,,,,
847,Back Cover 70,385,30,11550,,,,,,,,,,,,
848,Housing 70 Black,320,8,2560,,,,,,,,,,,,
849,,,,39454,,,,,,,,,,,,
850,Upper Cover Window,592,36,21312,11-18-13,,,,,,,,,,,
851,Back Cover 70,594,30,17820,,,,,,,,,,,,
852,Housing 70 Black,585,8,4680,,,,,,,,,,,,
853,,,,43812,,,,,,,,,,,,
854,Upper Cover Window,672,36,24192,11-20-13,,,,,,,,,,,
855,Back Cover 70,686,30,20580,,,,,,,,,,,,
856,Housing 70 Black,630,8,5040,,,,,,,,,,,,
857,Dial Blank qinque,1500,12,18000,,,,,,,,,,,,
858,,,,67812,,,,,,,,,,,,
859,Upper Cover Window,840,36,30240,11-22-13,,,,,,,,,,,
860,Housing 70 Black,640,8,5120,,,,,,,,,,,,
861,,,,35360,,,,,,,,,,,,
862,Upper Cover Window,452,36,16272,11-23-13,,,,,,,,,,,
863,Back Cover 70,582,30,17460,,,,,,,,,,,,
864,Housing 70 Black,520,8,4160,,,,,,,,,,,,
865,,,,37892,,,,,,,,,,,,
866,Upper Cover Qinque ,548,45,24660,11-25-13,,,,,,,,,,,
867,back Cover Qinque,540,20,10800,,,,,,,,,,,,
868,Housing Qinque,552,35,19320,,,,,,,,,,,,
869,Nest Qinque,500,20,10000,,,,,,,,,,,,
870,,,,64780,,,,,,,,,,,,
871,Upper Cover Zxmco,365,36,13140,11-28-13,,,,,,,,,,,
872,Back Cover 70,693,30,20790,,,,,,,,,,,,
873,Upper Cover Qinque ,534,45,24030,,,,,,,,,,,,
874,back Cover Qinque,300,20,6000,,,,,,,,,,,,
875,Housing Qinque,556,35,19460,,,,,,,,,,,,
876,Nest Qinque,190,20,3800,,,,,,,,,,,,
877,,,,87220,,,,,,,,,,,,
878,Dial Blank 70,5000,8,40000,11-29-13,,,,,,,,,,,
879,Upper Cover Window,766,36,27576,,,,,,,,,,,,
880,Back Cover 70,653,30,19590,,,,,,,,,,,,
881,Housing 70,530,8,4240,,,,,,,,,,,,
882,,,,91406,,,,,,,,,,,,
883,Upper Cover sohrab Jick,323,45,14535,12-02-13,,,,,,,,,,,
884,housing Qinque,416,35,14560,,,,,,,,,,,,
885,Back Cover sohrab js,310,20,6200,,,,,,,,,,,,
886,Nest Qinque,250,20,5000,,,,,,,,,,,,
887,Back Cover 70,729,30,21870,,,,,,,,,,,,
888,Housing 70 Black,464,8,3712,,,,,,,,,,,,
889,,,,65877,,,,,,,,,,,,
890,Upper Cover Window,228,36,8208,12-04-13,,,,,,,,,,,
891,Back Cover 70,582,30,17460,,,,,,,,,,,,
892,Housing 70,500,8,4000,,,,,,,,,,,,
893,,,,29668,,,,,,,,,,,,
894,Upper Cover Window,226,36,8136,12-05-13,,,,,,,,,,,
895,Back Cover 70,555,30,16650,,,,,,,,,,,,
896,Housing 70,508,8,4064,,,,,,,,,,,,
897,,,,28850,,,,,,,,,,,,
898,Upper Cover Window,573,36,20628,11-06-13,,,,,,,,,,,
899,Back Cover 70,663,30,19890,,,,,,,,,,,,
900,Housing 70,632,8,5056,,,,,,,,,,,,
901,,,,45574,,,,,,,,,,,,
902,Upper Cover Window,401,36,14436,12-09-13,,,,,,,,,,,
903,Upper Cover zxmco,332,36,11952,,,,,,,,,,,,
904,Back Cover 70,606,30,18180,,,,,,,,,,,,
905,Housing 70,660,8,5280,,,,,,,,,,,,
906,,,,49848,,,,,,,,,,,,
907,Upper Cover Window,421,36,15156,12-11-13,,,,,,,,,,,
908,Upper Cover zxmco,515,36,18540,,,,,,,,,,,,
909,Back Cover 70,933,30,27990,,,,,,,,,,,,
910,Housing 70,1014,8,8112,,,,,,,,,,,,
911,,,,69798,,,,,,,,,,,,
912,Upper Cover 70 New,759,36,27324,12-13-13,,,,,,,,,,,
913,Upper Cover Window,644,36,23184,,,,,,,,,,,,
914,Back Cover 70,756,30,22680,,,,,,,,,,,,
915,Housing 70 Black,765,8,6120,,,,,,,,,,,,
916,,,,79308,,,,,,,,,,,,
917,Upper Cover Window,820,36,29520,12-20-13,,,,,,,,,,,
918,Back Cover 70,653,30,19590,,,,,,,,,,,,
919,Housing 70 Black,837,8,6696,,,,,,,,,,,,
920,,,,55806,,,,,,,,,,,,
921,Upper Cover Window,531,36,19116,12-24-13,,,,,,,,,,,
922,Back Cover 70,552,30,16560,,,,,,,,,,,,
923,Housing 70 Black,612,8,4896,,,,,,,,,,,,
924,,,,40572,,,,,,,,,,,,
925,Dial Blank 70,5000,8,40000,12-26-13,,,,,,,,,,,
926,Dial Blank Qinque,1000,12,12000,,,,,,,,,,,,
927,Upper cover Qinque ,498,45,22410,,,,,,,,,,,,
928,Back cover Qinque,500,20,10000,,,,,,,,,,,,
929,Housing Qinque,500,35,17500,,,,,,,,,,,,
930,Nest Qinque,500,20,10000,,,,,,,,,,,,
931,,,,111910,,,,,,,,,,,,
932,Upper cover Qinque ,552,45,24840,12-30-13,,,,,,,,,,,
933,Back cover Qinque,620,20,12400,,,,,,,,,,,,
934,Housing Qinque,628,35,21980,,,,,,,,,,,,
935,Nest Qinque,540,20,10800,,,,,,,,,,,,
936,Upper Cover Window,728,36,26208,,,,,,,,,,,,
937,Back Cover 70,798,30,23940,,,,,,,,,,,,
938,Housing 70 Black,785,8,6280,,,,,,,,,,,,
939,,,,126448,,,,,,,,,,,,
940,Upper Cover Window,590,36,21240,01-01-14,,,,,,,,,,,
941,Back Cover 70,204,30,6120,,,,,,,,,,,,
942,Housing 70,707,8,5656,,,,,,,,,,,,
943,,,,33016,,,,,,,,,,,,
944,Upper Cover Window,601,36,21636,01-03-14,,,,,,,,,,,
945,Back Cover 70,1014,30,30420,,,,,,,,,,,,
946,Housing 70,540,8,4320,,,,,,,,,,,,
947,,,,56376,,,,,,,,,,,,
948,Upper Cover Window,534,36,19224,01-07-14,,,,,,,,,,,
949,Upper Cover 70 New,504,36,18144,,,,,,,,,,,,
950,Back Cover 70,798,30,23940,,,,,,,,,,,,
951,Housing 70 Black,884,8,7072,,,,,,,,,,,,
952,,,,68380,,,,,,,,,,,,
953,Upper Cover Window,804,36,28944,01-09-14,,,,,,,,,,,
954,Back Cover 70,1287,30,38610,,,,,,,,,,,,
955,Housing 70 Black,783,8,6264,,,,,,,,,,,,
956,,,,73818,,,,,,,,,,,,
957,Upper Cover Window,1033,36,37188,01-10-14,,,,,,,,,,,
958,Back Cover 70,1008,30,30240,,,,,,,,,,,,
959,Housing 70 Black,1004,8,8032,,,,,,,,,,,,
960,,,,75460,,,,,,,,,,,,
961,Dial Blank Qinque,1000,12,12000,01-13-14,,,,,,,,,,,
962,Dial Blank 70,3000,8,24000,,,,,,,,,,,,
963,Upper Cover Window,564,36,20304,,,,,,,,,,,,
964,Back Cover 70,756,30,22680,,,,,,,,,,,,
965,Housing 70 Black,696,8,5568,,,,,,,,,,,,
966,,,,84552,,,,,,,,,,,,
967,upper Cover Qinque ,822,45,36990,01-16-14,,,,,,,,,,,
968,Upper Cover Window,511,36,18396,,,,,,,,,,,,
969,Upper Cover Window,320,36,11520,,,,,,,,,,,,
970,Upper Cover Window,337,36,12132,,,,,,,,,,,,
971,Back Cover 70,1212,30,36360,,,,,,,,,,,,
972,Housing 70 Black,1197,8,9576,,,,,,,,,,,,
973,,,,124974,,,,,,,,,,,,
974,Upper cover Sohrab Leader,415,45,18675,01-17-14,,,,,,,,,,,
975,Back Cover qinque,750,20,15000,,,,,,,,,,,,
976,Nest Qinque,730,20,14600,,,,,,,,,,,,
977,,,,48275,,,,,,,,,,,,
978,Upper Cover Window,459,36,16524,01-23-14,,,,,,,,,,,
979,Back Cover 70,344,30,10320,,,,,,,,,,,,
980,Housing 70 Black,350,8,2800,,,,,,,,,,,,
981,,,,29644,,,,,,,,,,,,
982,Upper Cover Window,560,36,20160,01-24-14,,,,,,,,,,,
983,Upper Cover Unique,5,36,180,,,,,,,,,,,,
984,Back Cover 70,315,30,9450,,,,,,,,,,,,
985,Housing 70 Black,354,8,2832,,,,,,,,,,,,
986,,,,32622,,,,,,,,,,,,
987,Upper Cover Qinque ,334,45,15030,01-27-14,,,,,,,,,,,
988,back Cover qinque,1010,20,20200,,,,,,,,,,,,
989,Housing qinque,1005,35,35175,,,,,,,,,,,,
990,Nest Qinque,1022,20,20440,,,,,,,,,,,,
991,,,,90845,,,,,,,,,,,,
992,dial blank Qinque,1000,12,12000,01-27-14,,,,,,,,,,,
993,dial blank Sohrab js,5000,8,40000,,,,,,,,,,,,
994,Upper Cover Window,647,36,23292,,,,,,,,,,,,
995,Back Cover 70,333,30,9990,,,,,,,,,,,,
996,Housing 70 Black,360,8,2880,,,,,,,,,,,,
997,,,,88162,,,,,,,,,,,,
998,Upper Cover Window,576,36,20736,01-30-14,,,,,,,,,,,
999,Upper Cover Window,524,36,18864,01-31-14,,,,,,,,,,,
1000,Back Cover 70,600,30,18000,,,,,,,,,,,,
1001,Housing 70 Black,603,8,4824,,,,,,,,,,,,
1002,,,,41688,,,,,,,,,,,,
1003,Upper Cover Window,629,36,22644,02-01-14,,,,,,,,,,,
1004,Back Cover 70,897,30,26910,,,,,,,,,,,,
1005,Housing 70 Black,826,8,6608,,,,,,,,,,,,
1006,,,,56162,,,,,,,,,,,,
1007,Upper Cover Window,544,36,19584,02-03-14,,,,,,,,,,,
1008,Back Cover 70,580,30,17400,,,,,,,,,,,,
1009,Housing 70 Black,671,8,5368,,,,,,,,,,,,
1010,,,,42352,,,,,,,,,,,,
1011,Upper Cover Qinque ,411,45,18495,02-05-14,,,,,,,,,,,
1012,Upper Cover qinque ,751,45,33795,02-06-14,,,,,,,,,,,
1013,Upper Cover Window,610,36,21960,02-08-14,,,,,,,,,,,
1014,Back Cover 70,535,30,16050,,,,,,,,,,,,
1015,Housing 70 Black,666,8,5328,,,,,,,,,,,,
1016,,,,43338,,,,,,,,,,,,
1017,Upper Cover Window,1017,36,36612,02-11-14,,,,,,,,,,,
1018,Housing 70,708,8,5664,,,,,,,,,,,,
1019,Housing Qinque,532,35,18620,,,,,,,,,,,,
1020,back Cover Qinque,540,20,10800,,,,,,,,,,,,
1021,Nest Qinque,560,20,11200,,,,,,,,,,,,
1022,Dial blank Qinque,1000,12,12000,,,,,,,,,,,,
1023,,,,94896,,,,,,,,,,,,
1024,Back Cover 70,1260,30,37800,02-13-14,,,,,,,,,,,
1025,Housing 70 Black,924,8,7392,,,,,,,,,,,,
1026,Upper Cover Window,564,36,20304,,,,,,,,,,,,
1027,,,,65496,,,,,,,,,,,,
1028,Upper Cover Unique,262,36,9432,02-17-14,,,,,,,,,,,
1029,Upper Cover Window,502,36,18072,,,,,,,,,,,,
1030,Upper Cover Qinque ,503,45,22635,,,,,,,,,,,,
1031,Back Cover 70,639,30,19170,,,,,,,,,,,,
1032,Housing 70 Black,531,8,4248,,,,,,,,,,,,
1033,,,,73557,,,,,,,,,,,,
1034,Dial Blank 70,1000,8,8000,02-21-14,,,,,,,,,,,
1035,Dial Blank 70,5000,8,40000,,,,,,,,,,,,
1036,Upper Cover Window,995,36,35820,,,,,,,,,,,,
1037,Back Cover 70,1116,30,33480,,,,,,,,,,,,
1038,Housing 70 Black,798,8,6384,,,,,,,,,,,,
1039,,,,123684,,,,,,,,,,,,
1040,Upper Cover Window,814,36,29304,02-22-14,,,,,,,,,,,
1041,Back Cover 70,1024,30,30720,,,,,,,,,,,,
1042,Housing 70 Black,531,8,4248,,,,,,,,,,,,
1043,,,,64272,,,,,,,,,,,,
1044,Housing qinque,1003,35,35105,02-26-14,,,,,,,,,,,
1045,back Cover qinque,1040,20,20800,,,,,,,,,,,,
1046,nest Qinque,1060,20,21200,,,,,,,,,,,,
1047,,,,77105,,,,,,,,,,,,
1048,Upper Cover Qinque ,540,45,24300,02-27-14,,,,,,,,,,,
1049,housing Qinque,498,35,17430,,,,,,,,,,,,
1050,Back Cover Qinque,294,20,5880,,,,,,,,,,,,
1051,Nest Qinque,460,20,9200,,,,,,,,,,,,
1052,,,,56810,,,,,,,,,,,,
1053,Upper Cover 70 New,535,36,19260,02-28-14,,,,,,,,,,,
1054,Upper Cover Window,468,36,16848,,,,,,,,,,,,
1055,Back Cover 70,1056,30,31680,,,,,,,,,,,,
1056,Housing 70 Black,960,8,7680,,,,,,,,,,,,
1057,,,,75468,,,,,,,,,,,,
1058,upper cover qinque ,600,45,27000,03-03-14,,,,,,,,,,,
1059,Upper Cover Window,540,36,19440,,,,,,,,,,,,
1060,Back Cover 70,639,30,19170,,,,,,,,,,,,
1061,Housing 70,600,8,4800,,,,,,,,,,,,
1062,dial blank qinque,760,12,9120,,,,,,,,,,,,
1063,,,,79530,,,,,,,,,,,,
1064,Upper Cover Window,546,36,19656,03-04-14,,,,,,,,,,,
1065,Back Cover 70,1095,30,32850,,,,,,,,,,,,
1066,Housing 70 Black,975,8,7800,,,,,,,,,,,,
1067,,,,60306,,,,,,,,,,,,
1068,Dial blank qinque,520,12,6240,03-11-14,,,,,,,,,,,
1069,Upper Cover Window,836,36,30096,,,,,,,,,,,,
1070,Back Cover 70,900,30,27000,,,,,,,,,,,,
1071,Housing 70 Black,843,8,6744,,,,,,,,,,,,
1072,upper cover leader,214,45,9630,,,,,,,,,,,,
1073,,,,79710,,,,,,,,,,,,
1074,Upper Cover Window,1036,36,37296,03-12-14,,,,,,,,,,,
1075,Upper Cover Unique,188,36,6768,,,,,,,,,,,,
1076,Back Cover 70,888,30,26640,,,,,,,,,,,,
1077,Housing 70 Black,879,8,7032,,,,,,,,,,,,
1078,,,,77736,,,,,,,,,,,,
1079,upper cover qinque ,367,45,16515,03-17-14,,,,,,,,,,,
1080,Housing qinque,336,35,11760,,,,,,,,,,,,
1081,Upper Cover Window,640,36,23040,,,,,,,,,,,,
1082,Back Cover 70,586,30,17580,,,,,,,,,,,,
1083,Housing 70 Black,672,8,5376,,,,,,,,,,,,
1084,,,,74271,,,,,,,,,,,,
1085,Upper Cover Window,826,36,29736,03-19-14,,,,,,,,,,,
1086,Back Cover 70,891,30,26730,,,,,,,,,,,,
1087,Housing 70 Black,906,8,7248,,,,,,,,,,,,
1088,,,,63714,,,,,,,,,,,,
1089,Upper Cover Window,996,36,35856,03-20-14,,,,,,,,,,,
1090,Back Cover 70,975,30,29250,,,,,,,,,,,,
1091,Housing 70 Black,1044,8,8352,,,,,,,,,,,,
1092,,,,73458,,,,,,,,,,,,
1093,upper cover qinque ,1008,45,45360,03-29-14,,,,,,,,,,,
1094,Back cover qinque,1040,20,20800,,,,,,,,,,,,
1095,Housing qinque,1003,35,35105,,,,,,,,,,,,
1096,Nest qinque,1100,20,22000,,,,,,,,,,,,
1097,,,,123265,,,,,,,,,,,,
1098,Upper Cover Window,1010,36,36360,04-01-14,,,,,,,,,,,
1099,Back Cover 70,1036,30,31080,,,,,,,,,,,,
1100,Housing 70 Black,1092,8,8736,,,,,,,,,,,,
1101,,,,76176,,,,,,,,,,,,
1102,Dial blank qinque (Amir,1000,12,12000,05-Apr-14,,,,,,,,,,,
1103,Upper Cover Window,1014,36,36504,,,,,,,,,,,,
1104,Back Cover 70,796,30,23880,,,,,,,,,,,,
1105,Housing Black 70,1579,8,12632,,,,,,,,,,,,
1106,,,,85016,,,,,,,,,,,,
1107,Upper cover zemco,1045,36,37620,04-10-14,,,,,,,,,,,
1108,Back Cover 70,1074,30,32220,,,,,,,,,,,,
1109,Housing 70 Black,1118,8,8944,,,,,,,,,,,,
1110,,,,78784,,,,,,,,,,,,
1111,Upper cover window ,102,36,3672,21-04-14,,,,,,,,,,,
1112,Upper Cover unique,147,36,5292,,,,,,,,,,,,
1113,Back Cover 70,981,30,29430,,,,,,,,,,,,
1114,Housing 70 ,1230,8,9840,,,,,,,,,,,,
1115,,,,48234,,,,,,,,,,,,
1116,Upper Cover Window,1016,36,36576,24-04-14,,,,,,,,,,,
1117,Back Cover 70,1023,30,30690,,,,,,,,,,,,
1118,Housing 70 ,1020,8,8160,,,,,,,,,,,,
1119,,,,75426,,,,,,,,,,,,
1120,Upper Cover Window,1026,36,36936,28-04-14,,,,,,,,,,,
1121,Back Cover 70,799,30,23970,,,,,,,,,,,,
1122,Housing 70 ,1066,8,8528,,,,,,,,,,,,
1123,,,,69434,,,,,,,,,,,,
1124,Dial Blank Qinque,1000,12,12000,04-30-14,,,,,,,,,,,
1125,Upper cover qinque,1002,45,45090,,,,,,,,,,,,
1126,Backcoverqinque,1000,20,20000,,,,,,,,,,,,
1127,Housing Qinque,1000,35,35000,,,,,,,,,,,,
1128,Nest Qinque,1030,20,20600,,,,,,,,,,,,
1129,,,,112690,,,,,,,,,,,,
1130,Dial Blank 70,1000,8,8000,05-07-14,,,,,,,,,,,
1131,Upper Cover Window,1041,36,37476,,,,,,,,,,,,
1132,Housing  70 black,791,8,6328,,,,,,,,,,,,
1133,,,,51804,,,,,,,,,,,,
1134,Back Cover 70,423,30,12690,05-08-14,,,,,,,,,,,
1135,Housing  70 black,476,8,3808,,,,,,,,,,,,
1136,,,,16498,,,,,,,,,,,,
1137,Upper Cover  window,636,36,22896,05-09-14,,,,,,,,,,,
1138,Upper Cover  window,636,36,22896,10-05-14,,,,,,,,,,,
1139,Upper Cover Window,178,36,6408,12-05-14,,,,,,,,,,,
1140,Back Cover 70,980,30,29400,12-05-14,,,,,,,,,,,
1141,,,,35808,,,,,,,,,,,,
1142,Back Cover 70,746,30,22380,13-05-14,,,,,,,,,,,
1143,Housing  70 black,735,8,5880,13-05-14,,,,,,,,,,,
1144,Upper Cover  window,661,36,23796,13-05-14,,,,,,,,,,,
1145,,,,52056,,,,,,,,,,,,
1146,Dial Blank 70,1000,8,8000,14-05-14,,,,,,,,,,,
1147,Upper Cover  window,616,36,22176,15-05-14,,,,,,,,,,,
1148,Back Cover 70,708,30,21240,,,,,,,,,,,,
1149,Housing  70 black,684,8,5472,,,,,,,,,,,,
1150,,,,48888,,,,,,,,,,,,
1151,Upper Cover  window,636,36,22896,16-05-14,,,,,,,,,,,
1152,Backcover 70,666,30,19980,,,,,,,,,,,,
1153,Housing  70 black,504,8,4032,,,,,,,,,,,,
1154,,,,46908,,,,,,,,,,,,
1155,Upper Cover Window,709,36,25524,20-05-14,,,,,,,,,,,
1156,Back Cover 70,798,30,23940,,,,,,,,,,,,
1157,Housing  70 black,556,8,4448,,,,,,,,,,,,
1158,,,,53912,,,,,,,,,,,,
1159,Upper Cover Window,730,36,26280,23-05-14,,,,,,,,,,,
1160,Back Cover 70,757,30,22710,,,,,,,,,,,,
1161,Housing  70 black,780,8,6240,,,,,,,,,,,,
1162,,,,55230,,,,,,,,,,,,
1163,Back Cover 70,834,30,25020,24-05-14,,,,,,,,,,,
1164,Housing  70 black,900,8,7200,,,,,,,,,,,,
1165,,,,32220,,,,,,,,,,,,
1166,Upper Cover  window,852,36,30672,27-05-14,,,,,,,,,,,
1167,Dial blank qinque,1000,12,12000,,,,,,,,,,,,
1168,,,,42672,,,,,,,,,,,,
1169,Upper Cover  Qinque,1068,45,48060,29-05-14,,,,,,,,,,,
1170,Houseing qinque ,1090,35,38150,,,,,,,,,,,,
1171,Nest Qinque,1050,20,21000,,,,,,,,,,,,
1172,Back Cover Qinque,1080,20,21600,,,,,,,,,,,,
1173,,,,128810,,,,,,,,,,,,
1174,Upper Cover  window,797,36,28692,30-05-14,,,,,,,,,,,
1175,Back Cover 70,418,30,12540,,,,,,,,,,,,
1176,Houseing 70 Black,750,8,6000,,,,,,,,,,,,
1177,,,,47232,,,,,,,,,,,,
1178,Upper Cover Window,450,36,16200,31-05-14,,,,,,,,,,,
1179,Back Cover 70,609,30,18270,,,,,,,,,,,,
1180,Housing  70 black,609,8,4872,,,,,,,,,,,,
1181,,,,39342,,,,,,,,,,,,
1182,Upper Cover  window,376,36,13536,02-06-14,,,,,,,,,,,
1183,Back Cover 70,585,30,17550,,,,,,,,,,,,
1184,Houseing 70 Black,624,8,4992,,,,,,,,,,,,
1185,,,,36078,,,,,,,,,,,,
1186,Upper Cover  window,813,36,29268,04-06-14,,,,,,,,,,,
1187,Back Cover 70,777,30,23310,,,,,,,,,,,,
1188,houseing 70 Black,796,8,6368,,,,,,,,,,,,
1189,,,,58946,,,,,,,,,,,,
1190,Upper Cover  window,470,36,16920,05-06-14,,,,,,,,,,,
1191,Back Cover 70,492,30,14760,,,,,,,,,,,,
1192,houseing 70 Black,477,8,3816,,,,,,,,,,,,
1193,,,,35496,,,,,,,,,,,,
1194,Upper Cover  window,742,36,26712,10-06-14,,,,,,,,,,,
1195,Back Cover 70,816,30,24480,,,,,,,,,,,,
1196,houseing 70 Black,804,8,6432,,,,,,,,,,,,
1197,,,,57624,,,,,,,,,,,,
1198,Upper Cover  window,365,36,13140,13-06-14,,,,,,,,,,,
1199,Back Cover 70,666,30,19980,,,,,,,,,,,,
1200,houseing 70 Black,310,8,2480,,,,,,,,,,,,
1201,,,,35600,,,,,,,,,,,,
1202,Upper Cover  window,1084,36,39024,17-06-14,,,,,,,,,,,
1203,Back Cover 70,1125,30,33750,,,,,,,,,,,,
1204,Hoiusing 70 black,984,8,7872,,,,,,,,,,,,
1205,,,,80646,,,,,,,,,,,,
1206,Upper Cover  UNIQUI,177,36,6372,20-06-14,,,,,,,,,,,
1207,Upper Cover Zxmco,813,36,29268,,,,,,,,,,,,
1208,Back Cover 70,995,30,29850,,,,,,,,,,,,
1209,Houseing 70 Black,1032,8,8256,,,,,,,,,,,,
1210,,,,73746,,,,,,,,,,,,
1211,upper Cover  zxmco,524,36,18864,23-06-14,,,,,,,,,,,
1212,Back Cover 70,570,30,17100,,,,,,,,,,,,
1213,,,,35964,,,,,,,,,,,,
1214,Back Cover 70,713,36,21390,25-06-14,,,,,,,,,,,
1215,Hosing 70Black,888,30,7104,,,,,,,,,,,,
1216,,,,28494,,,,,,,,,,,,
1217,Upper Cover  window,583,36,20988,26-06-14,,,,,,,,,,,
1218,Back Cover 70,636,30,19080,,,,,,,,,,,,
1219,Hosing 70Black,624,8,4992,,,,,,,,,,,,
1220,,,,45060,,,,,,,,,,,,
1221,Upper Cover  window,647,36,23292,27-06-14,,,,,,,,,,,
1222,Back Cover 70,839,30,25170,,,,,,,,,,,,
1223,Hoiusing 70,1592,8,12736,,,,,,,,,,,,
1224,,,,61198,,,,,,,,,,,,
1225,Upper Cover  window,889,36,32004,28-06-14,,,,,,,,,,,
1226,Back Cover 70,1253,30,37590,,,,,,,,,,,,
1227,Hosing 70Black,1452,8,11616,,,,,,,,,,,,
1228,,,,81210,,,,,,,,,,,,
1229,Upper Cover  window,140,36,5040,01-07-14,,,,,,,,,,,
1230,Back Cover 70,1085,30,32550,,,,,,,,,,,,
1231,Hoiusing 70 black,1108,8,8864,,,,,,,,,,,,
1232,,,,46454,,,,,,,,,,,,
1233,Upper Cover  window,897,36,32292,02-07-14,,,,,,,,,,,
1234,Back Cover 70,906,30,27180,,,,,,,,,,,,
1235,Hoiusing 70 Black,893,8,7144,,,,,,,,,,,,
1236,,,,66616,,,,,,,,,,,,
1237,upper Cover  Qinque,1003,45,45135,03-07-14,,,,,,,,,,,
1238,hosing qinque,1000,35,35000,,,,,,,,,,,,
1239,nest Qinque,1000,20,20000,,,,,,,,,,,,
1240,back Coverqinque,1000,20,20000,,,,,,,,,,,,
1241,,,,120135,,,,,,,,,,,,
1242,Upper Cover  window,600,36,21600,04-07-14,,,,,,,,,,,
1243,Back Cover 70,666,30,19980,,,,,,,,,,,,
1244,Hosing 70Black,676,8,5408,,,,,,,,,,,,
1245,,,,46988,,,,,,,,,,,,
1246,Upper Cover  window,316,36,11376,08-07-14,,,,,,,,,,,
1247,Back Cover 70,615,30,18450,,,,,,,,,,,,
1248,Hosing 70Black,636,8,5088,,,,,,,,,,,,
1249,,,,34914,,,,,,,,,,,,
1250,Upper Cover Window,532,36,19152,09-07-14,,,,,,,,,,,
1251,Back Cover 70,703,30,21090,,,,,,,,,,,,
1252,Hosing 70Black,756,8,6048,,,,,,,,,,,,
1253,,,,46290,,,,,,,,,,,,
1254,Upper Cover  window,811,36,29196,10-07-14,,,,,,,,,,,
1255,Back Cover 70,794,30,23820,,,,,,,,,,,,
1256,Hosing 70Black,561,8,4488,,,,,,,,,,,,
1257,dial Blank qinque,1000,12,12000,,,,,,,,,,,,
1258,,,,69504,,,,,,,,,,,,
1259,upper Cover  uNIQUI,94,36,3384,17-07-14,,,,,,,,,,,
1260,Upper Cover  window,1069,36,38484,,,,,,,,,,,,
1261,Back Cover 70,958,30,28740,,,,,,,,,,,,
1262,Hosing 70Black,341,8,2728,,,,,,,,,,,,
1263,,,,73336,,,,,,,,,,,,
1264,upper Cover  zxmco,1496,36,53856,18-07-14,,,,,,,,,,,
1265,Back Cover 70,506,30,15180,,,,,,,,,,,,
1266,Hosing 70Black,853,8,6824,,,,,,,,,,,,
1267,,,,75860,,,,,,,,,,,,
1268,upper Cover  uNIQUI,94,36,3384,21-07-14,,,,,,,,,,,
1269,Upper Cover  window,1012,36,36432,27-07-14,,,,,,,,,,,
1270,Back Cover 70,1113,30,33390,,,,,,,,,,,,
1271,Hosing 70Black,1032,8,8256,,,,,,,,,,,,
1272,,,,78078,,,,,,,,,,,,
1273,Upper Cover  window,1051,36,37836,06-08-14,,,,,,,,,,,
1274,Back Cover 70,1010,30,30300,,,,,,,,,,,,
1275,Hosing 70Black,1016,8,8128,,,,,,,,,,,,
1276,,,,76264,,,,,,,,,,,,
1277,Upper Cover  Qinque,396,45,17820,09-08-14,,,,,,,,,,,
1278,Back Cover qinque,1000,20,20000,,,,,,,,,,,,
1279,Hosing qinque,558,35,19530,,,,,,,,,,,,
1280,Nest Qinque,1000,20,20000,,,,,,,,,,,,
1281,Upper Cover  window,188,36,6768,,,,,,,,,,,,
1282,Back Cover 70,538,30,16140,,,,,,,,,,,,
1283,upper Cover  uNIQUI,282,36,10152,,,,,,,,,,,,
1284,,,,110410,,,,,,,,,,,,
1285,Upper Cover  window,520,36,18720,12-08-14,,,,,,,,,,,
1286,Back Cover 70,863,30,25890,,,,,,,,,,,,
1287,Hosing 70Black,1575,8,12600,,,,,,,,,,,,
1288,upper Cover  Qinque,180,45,8100,,,,,,,,,,,,
1289,,,,65310,,,,,,,,,,,,
1290,dial Blank qinque,1000,12,12000,12-08-14,,,,,,,,,,,
1291,Upper Cover  window,1567,36,56412,13-08-14,,,,,,,,,,,
1292,Back Cover 70,220,30,6600,,,,,,,,,,,,
1293,Hosing 70Black,504,8,4032,,,,,,,,,,,,
1294,upper Cover  Qinque,430,45,19350,,,,,,,,,,,,
1295,,,,86394,,,,,,,,,,,,
1296,Upper Cover  window,797,36,28692,15-08-14,,,,,,,,,,,
1297,Back Cover 70,522,30,15660,,,,,,,,,,,,
1298,Hosing 70Black,312,8,2496,,,,,,,,,,,,
1299,hosing qinque,528,35,18480,,,,,,,,,,,,
1300,,,,65328,,,,,,,,,,,,
1301,Upper Cover  window,1038,36,37368,22-08-14,,,,,,,,,,,
1302,Back Cover 70,130,30,3900,,,,,,,,,,,,
1303,Hosing 70Black,1072,8,8576,,,,,,,,,,,,
1304,,,,49844,,,,,,,,,,,,
1305,Upper Cover  window,354,36,12744,23-08-14,,,,,,,,,,,
1306,Back Cover 70,470,30,14100,,,,,,,,,,,,
1307,,,,26844,,,,,,,,,,,,
1308,Upper Cover  window,637,36,22932,27-08-14,,,,,,,,,,,
1309,Back Cover 70,871,30,26130,,,,,,,,,,,,
1310,Hosing 70Black,873,8,6984,,,,,,,,,,,,
1311,,,,56046,,,,,,,,,,,,
1312,Upper Cover  window,647,36,23292,26-08-14,,,,,,,,,,,
1313,Back Cover 70,426,30,12780,,,,,,,,,,,,
1314,Hosing 70Black,156,8,1248,,,,,,,,,,,,
1315,,,,37320,,,,,,,,,,,,
1316,Upper Cover  window,647,36,23292,28-08-14,,,,,,,,,,,
1317,Back Cover 70,1047,30,31410,,,,,,,,,,,,
1318,Hosing 70Black,678,8,5424,,,,,,,,,,,,
1319,,,,60126,,,,,,,,,,,,
1320,dial Blank qinque,1000,12,12000,29-08-14,,,,,,,,,,,
1321,upper Cover  Qinque,320,45,14400,02-09-14,,,,,,,,,,,
1322,back Cover qinque,1500,20,30000,,,,,,,,,,,,
1323,hosing qinque,90,35,3150,,,,,,,,,,,,
1324,nest Qinque,710,20,14200,,,,,,,,,,,,
1325,,,,61750,,,,,,,,,,,,
1326,Upper Cover  window,710,36,25560,04-09-14,,,,,,,,,,,
1327,Back Cover 70,1638,30,49140,,,,,,,,,,,,
1328,hosing qinque,1520,35,53200,,,,,,,,,,,,
1329,,,,127900,,,,,,,,,,,,
1330,Upper Cover  window,331,36,11916,06-09-14,,,,,,,,,,,
1331,Back Cover 70,302,30,9060,,,,,,,,,,,,
1332,Hosing 70Black,1536,8,12288,,,,,,,,,,,,
1333,,,,33264,,,,,,,,,,,,
1334,Upper Cover  Qinque,415,45,18675,10-09-14,,,,,,,,,,,
1335,Nest Qinque,180,20,3600,,,,,,,,,,,,
1336,upper Cover  70,430,36,15480,,,,,,,,,,,,
1337,Back Cover 70,570,30,17100,,,,,,,,,,,,
1338,Hosing 70Black,1000,8,8000,,,,,,,,,,,,
1339,,,,62855,,,,,,,,,,,,
1340,Upper Cover  Qinque,300,45,13500,11-09-14,,,,,,,,,,,
1341,Nest Qinque,500,20,10000,,,,,,,,,,,,
1342,Back Cover 70,370,30,11100,,,,,,,,,,,,
1343,Hosing 70Black,360,8,2880,,,,,,,,,,,,
1344,,,,37480,,,,,,,,,,,,
1345,Upper Cover  window,658,36,23688,13-09-14,,,,,,,,,,,
1346,Upper Cover  window,255,36,9180,,,,,,,,,,,,
1347,Back Cover 70,200,30,6000,,,,,,,,,,,,
1348,Hoiusing 70,400,8,3200,,,,,,,,,,,,
1349,,,,42068,,,,,,,,,,,,
1350,Upper Cover  Qinque,500,45,22500,16-09-14,,,,,,,,,,,
1351,Back Cover 70,500,30,15000,,,,,,,,,,,,
1352,Hosing 70Black,670,8,5360,,,,,,,,,,,,
1353,,,,42860,,,,,,,,,,,,
1354,upper Cover  zxmco,1072,36,38592,17-09-14,,,,,,,,,,,
1355,Back Cover 70,730,30,21900,,,,,,,,,,,,
1356,Hosing 70Black,800,8,6400,,,,,,,,,,,,
1357,,,,66892,,,,,,,,,,,,
1358,Dial Blank Qinque,890,12,10680,18-09-14,,,,,,,,,,,
1359,Upper Cover Window,956,36,34416,29-09-14,,,,,,,,,,,
1360,Back Cover 70,300,30,9000,,,,,,,,,,,,
1361,Hosing 70Black,900,8,7200,,,,,,,,,,,,
1362,Upper Cover  Qinque,186,45,8370,,,,,,,,,,,,
1363,Back Cover Qinque,200,20,4000,,,,,,,,,,,,
1364,Nest Qinque,240,20,4800,,,,,,,,,,,,
1365,Hosing qinque,23,35,805,,,,,,,,,,,,
1366,,,,68591,,,,,,,,,,,,
1367,Upper Cover  Qinque,446,45,20070,01-10-14,,,,,,,,,,,
1368,Hosing qinque,500,35,17500,,,,,,,,,,,,
1369,Nest Qinque,500,20,10000,,,,,,,,,,,,
1370,upper Cover  window 70,500,35,17500,,,,,,,,,,,,
1371,Hosing 70Black,1000,8,8000,,,,,,,,,,,,
1372,,,,73070,,,,,,,,,,,,
1373,Upper Cover Window,323,35,11305,02-10-14,,,,,,,,,,,
1374,Back Cover 70,420,30,12600,,,,,,,,,,,,
1375,Hosing 70Black,460,8,3680,,,,,,,,,,,,
1376,,,,27585,,,,,,,,,,,,
1377,Upper Cover Window,177,35,6195,03-10-14,,,,,,,,,,,
1378,Back Cover 70,200,30,6000,,,,,,,,,,,,
1379,Hosing 70Black,510,8,4080,,,,,,,,,,,,
1380,upper Cover  zxmco,578,36,20808,,,,,,,,,,,,
1381,,,,37083,,,,,,,,,,,,
1382,Upper Cover Window,544,35,19040,09-10-14,,,,,,,,,,,
1383,Back Cover 70,980,30,29400,,,,,,,,,,,,
1384,Hosing 70Black,1136,8,9088,,,,,,,,,,,,
1385,,,,57528,,,,,,,,,,,,
1386,Upper Cover  Qinque,166,45,7470,10-10-14,,,,,,,,,,,
1387,Upper Cover Window,300,35,10500,,,,,,,,,,,,
1388,Back Cover 70,640,30,19200,,,,,,,,,,,,
1389,Hosing 70Black,632,8,5056,,,,,,,,,,,,
1390,,,,42226,,,,,,,,,,,,
1391,Upper Cover  Qinque,726,45,32670,14-10-14,,,,,,,,,,,
1392,Hosing qinque,480,35,16800,,,,,,,,,,,,
1393,Nest Qinque,600,20,12000,,,,,,,,,,,,
1394,back  cover qinque,500,20,10000,,,,,,,,,,,,
1395,,,,71470,,,,,,,,,,,,
1396,Upper Cover  window,909,35,31815,15-10-14,,,,,,,,,,,
1397,Back Cover 70,280,30,8400,,,,,,,,,,,,
1398,Hosing 70Black,865,8,6920,,,,,,,,,,,,
1399,,,,47135,,,,,,,,,,,,
1400,Dial Blank Qinque,2700,12,32400,18-10-14,,,,,,,,,,,
1401,Upper Cover  window,535,35,18725,,,,,,,,,,,,
1402,Upper Cover  window,737,35,25795,,,,,,,,,,,,
1403,Hosing qinque,534,35,18690,,,,,,,,,,,,
1404,Back Cover Qinque,500,20,10000,,,,,,,,,,,,
1405,Nest Qinque,520,20,10400,,,,,,,,,,,,
1406,Hosing 70Black,780,8,6240,,,,,,,,,,,,
1407,,,,122250,,,,,,,,,,,,
1408,Dial Blank Qinque,400,12,4800,16-10-14,,,,,,,,,,,
1409,Upper Cover  window,546,35,19110,,,,,,,,,,,,
1410,Back Cover 70,585,30,17550,,,,,,,,,,,,
1411,Hosing 70Black,500,8,4000,,,,,,,,,,,,
1412,Upper Cover  Qinque,300,45,13500,,,,,,,,,,,,
1413,Hosing qinque,110,35,3850,,,,,,,,,,,,
1414,Back Cover Qinque,300,20,6000,,,,,,,,,,,,
1415,Nest Qinque,400,20,8000,,,,,,,,,,,,
1416,,,,76810,,,,,,,,,,,,
1417,Upper Cover  Qinque,484,45,21780,20-10-14,,,,,,,,,,,
1418,Upper Cover  window,535,35,18725,,,,,,,,,,,,
1419,Hosing 70Black,486,8,3888,,,,,,,,,,,,
1420,,,,44393,,,,,,,,,,,,
1421,Upper Cover  window,969,35,33915,21-10-14,,,,,,,,,,,
1422,Back Cover 70,532,30,15960,,,,,,,,,,,,
1423,Hosing 70Black,300,8,2400,,,,,,,,,,,,
1424,,,,52275,,,,,,,,,,,,
1425,Upper Cover  Qinque,466,45,20970,22-10-14,,,,,,,,,,,
1426,Back Cover Qinque,140,20,2800,,,,,,,,,,,,
1427,,,,23770,,,,,,,,,,,,
1428,Back Cover 70,1063,30,31890,27-10-14,,,,,,,,,,,
1429,Back Cover 70,657,30,19710,23-10-14,,,,,,,,,,,
1430,Back Cover qinque,330,20,6600,30-10-14,,,,,,,,,,,
1431,upper Cover  Qinque,520,45,23400,31-10-14,,,,,,,,,,,
1432,upper Cover  Qinque   cd,516,45,23220,,,,,,,,,,,,
1433,hosing qinque,915,35,32025,,,,,,,,,,,,
1434,nest Qinque,510,20,10200,,,,,,,,,,,,
1435,back Cover qinque,200,20,4000,,,,,,,,,,,,
1436,,,,92845,,,,,,,,,,,,
1437,Back Cover 70,306,30,9180,01-11-14,,,,,,,,,,,
1438,Hosing 70Black,730,8,5840,,,,,,,,,,,,
1439,,,,15020,,,,,,,,,,,,
1440,Back Cover 70,990,30,29700,05-11-14,,,,,,,,,,,
1441,Upper Cover  window,194,36,6984,,,,,,,,,,,,
1442,Back Cover 70,196,30,5880,,,,,,,,,,,,
1443,Hosing 70Black,470,8,3760,,,,,,,,,,,,
1444,,,,46324,,,,,,,,,,,,
1445,Upper Cover  window,177,35,6195,06-11-14,,,,,,,,,,,
1446,Back Cover 70,830,30,24900,,,,,,,,,,,,
1447,Hosing 70Black,303,8,2424,,,,,,,,,,,,
1448,,,,33519,,,,,,,,,,,,
1449,Upper Cover  window,806,35,28210,07-11-14,,,,,,,,,,,
1450,Back Cover 70,804,30,24120,,,,,,,,,,,,
1451,Hosing 70Black,283,8,2264,,,,,,,,,,,,
1452,,,,54594,,,,,,,,,,,,
1453,Upper Cover  window,282,35,9870,08-11-14,,,,,,,,,,,
1454,Back Cover 70,222,30,6660,,,,,,,,,,,,
1455,Hosing 70Black,1080,8,8640,,,,,,,,,,,,
1456,Upper Cover  window,600,35,21000,,,,,,,,,,,,
1457,Back Cover qinque,1050,20,21000,,,,,,,,,,,,
1458,,,,67170,,,,,,,,,,,,
1459,dial Blank qinque,1640,12,19680,11-10-14,,,,,,,,,,,
1460,Upper Cover  window,148,35,5180,,,,,,,,,,,,
1461,Back Cover 70,769,30,23070,,,,,,,,,,,,
1462,Hosing 70Black,1080,8,8640,,,,,,,,,,,,
1463,,,,56570,,,,,,,,,,,,
1464,Upper Cover  window,681,35,23835,11-11-14,,,,,,,,,,,
1465,Back Cover 70,330,30,9900,,,,,,,,,,,,
1466,Hosing 70Black,312,8,2496,,,,,,,,,,,,
1467,,,,36231,,,,,,,,,,,,
1468,Upper Cover Window,356,35,12460,13-11-14,,,,,,,,,,,
1469,Hosing 70Black,576,8,4608,,,,,,,,,,,,
1470,hosing qinque,330,35,11550,,,,,,,,,,,,
1471,nest Qinque,538,20,10760,,,,,,,,,,,,
1472,,,,39378,,,,,,,,,,,,
1473,upper Cover  Qinque,493,45,22185,15-11-14,,,,,,,,,,,
1474,Back Cover qinque,531,20,10620,,,,,,,,,,,,
1475,nest Qinque,480,20,9600,,,,,,,,,,,,
1476,Back Cover 70,528,30,15840,,,,,,,,,,,,
1477,Hosing 70Black,264,8,2112,,,,,,,,,,,,
1478,,,,60357,,,,,,,,,,,,
1479,Back Cover 70,339,30,10170,17-11-14,,,,,,,,,,,
1480,back Cover qinque,500,20,10000,,,,,,,,,,,,
1481,nest Qinque,500,20,10000,,,,,,,,,,,,
1482,,,,30170,,,,,,,,,,,,
1483,Upper Cover  window,490,35,17150,18-11-14,,,,,,,,,,,
1484,Back Cover 70,494,30,14820,,,,,,,,,,,,
1485,Hosing 70Black,612,8,4896,,,,,,,,,,,,
1486,,,,36866,,,,,,,,,,,,
1487,Upper Cover  window,1033,35,36155,18-11-14,,,,,,,,,,,
1488,Back Cover 70,605,30,18150,,,,,,,,,,,,
1489,Hosing 70Black,420,8,3360,,,,,,,,,,,,
1490,upper Cover  Qinque,258,45,11610,,,,,,,,,,,,
1491,hosing qinque,512,35,17920,,,,,,,,,,,,
1492,,,,87195,,,,,,,,,,,,
1493,dial Blank qinque,2000,12,24000,22-11-14,,,,,,,,,,,
1494,Upper Cover  window,596,35,20860,,,,,,,,,,,,
1495,Back Cover 70,579,30,17370,,,,,,,,,,,,
1496,Hosing 70Black,591,8,4728,,,,,,,,,,,,
1497,Back Cover 70,872,30,26160,25-11-14,,,,,,,,,,,
1498,upper Cover  Qinque,432,45,19440,28-11-14,,,,,,,,,,,
1499,Hosing qinque,1006,35,35210,,,,,,,,,,,,
1500,Back Cover qinque,1000,20,20000,,,,,,,,,,,,
1501,nest Qinque,1000,20,20000,,,,,,,,,,,,
1502,Hosing 70Black,392,8,3136,,,,,,,,,,,,
1503,,,,97786,,,,,,,,,,,,
1504,Upper Cover  window,363,35,12705,01-12-14,,,,,,,,,,,
1505,Back Cover 70,315,30,9450,,,,,,,,,,,,
1506,Hosing 70Black,425,8,3400,,,,,,,,,,,,
1507,,,,25555,,,,,,,,,,,,
1508,Upper Cover  window,618,35,21630,02-12-14,,,,,,,,,,,
1509,Back Cover 70,555,30,16650,,,,,,,,,,,,
1510,Hosing 70Black,360,8,2880,,,,,,,,,,,,
1511,,,,41160,,,,,,,,,,,,
1512,Upper Cover  window,358,35,12530,03-12-14,,,,,,,,,,,
1513,Back Cover 70,477,30,14310,,,,,,,,,,,,
1514,hosing qinque,1001,35,35035,,,,,,,,,,,,
1515,nest Qinque,810,20,16200,,,,,,,,,,,,
1516,back Cover qinque,1000,20,20000,,,,,,,,,,,,
1517,,,,98075,,,,,,,,,,,,
1518,Upper Cover  window,188,35,6580,04-12-14,,,,,,,,,,,
1519,Back Cover 70,543,30,16290,,,,,,,,,,,,
1520,Hosing 70Black,155,8,1240,,,,,,,,,,,,
1521,,,,24110,,,,,,,,,,,,
1522,Upper Cover  window,697,35,24395,05-12-14,,,,,,,,,,,
1523,Back Cover 70,528,30,15840,,,,,,,,,,,,
1524,Hosing 70Black,720,8,5760,,,,,,,,,,,,
1525,,,,45995,,,,,,,,,,,,
1526,upper Cover  Qinque,726,45,32670,06-12-14,,,,,,,,,,,
1527,upper Cover  Qinque,143,45,6435,06-12-14,,,,,,,,,,,
1528,upper Cover  Qinque,209,45,9405,08-12-14,,,,,,,,,,,
1529,Upper Cover  window,741,35,25935,,,,,,,,,,,,
1530,Back Cover 70,701,30,21030,,,,,,,,,,,,
1531,Hosing 70Black,1004,8,8032,,,,,,,,,,,,
1532,,,,64402,,,,,,,,,,,,
1533,upper Cover  Qinque,1067,45,48015,11-12-14,,,,,,,,,,,
1534,Upper Cover  window,177,35,6195,,,,,,,,,,,,
1535,Back Cover 70,444,30,13320,,,,,,,,,,,,
1536,Hosing 70Black,615,8,4920,,,,,,,,,,,,
1537,,,,72450,,,,,,,,,,,,
1538,Upper Cover  window,366,35,12810,12-12-14,,,,,,,,,,,
1539,Back Cover 70,648,30,19440,,,,,,,,,,,,
1540,Hosing 70Black,510,8,4080,,,,,,,,,,,,
1541,,,,36330,,,,,,,,,,,,
1542,Upper Cover  window,499,35,17465,15-12-14,,,,,,,,,,,
1543,Back Cover 70,977,30,29310,,,,,,,,,,,,
1544,,,,46775,,,,,,,,,,,,
1545,upper Cover  Qinque,300,45,13500,16-12-14,,,,,,,,,,,
1546,Upper Cover  window,762,35,26670,,,,,,,,,,,,
1547,Hosing 70Black,935,8,7480,,,,,,,,,,,,
1548,,,,47650,,,,,,,,,,,,
1549,Back Cover Qinque,970,20,19400,18-12-14,,,,,,,,,,,
1550,Nest Qinque,1060,20,21200,,,,,,,,,,,,
1551,,,,40600,,,,,,,,,,,,
1552,Upper Cover  window,83,35,2905,20-12-14,,,,,,,,,,,
1553,Back Cover 70,750,30,22500,,,,,,,,,,,,
1554,Hosing 70Black,667,8,5336,,,,,,,,,,,,
1555,Upper Cover  window,679,35,23765,,,,,,,,,,,,
1556,,,,54506,,,,,,,,,,,,
1557,Dial Blank qinque,2000,12,24000,23-12-14,,,,,,,,,,,
1558,Upper Cover  window,749,35,26215,,,,,,,,,,,,
1559,Back Cover 70,749,30,22470,,,,,,,,,,,,
1560,,,,72685,,,,,,,,,,,,
1561,Upper Cover  window,274,35,9590,24-12-14,,,,,,,,,,,
1562,Back Cover 70,747,30,22410,,,,,,,,,,,,
1563,Hosing 70Black,234,8,1872,,,,,,,,,,,,
1564,,,,33872,,,,,,,,,,,,
1565,Upper Cover  window,148,35,5180,26-12-14,,,,,,,,,,,
1566,Back Cover 70,520,30,15600,,,,,,,,,,,,
1567,Hoiusing 70,496,8,3968,,,,,,,,,,,,
1568,,,,24748,,,,,,,,,,,,
1569,Back Cover 70,1010,30,30300,29-12-14,,,,,,,,,,,
1570,Hoiusing 70,760,8,6080,,,,,,,,,,,,
1571,,,,36380,,,,,,,,,,,,
1572,Hosing qinque,541,35,18935,29-12-14,,,,,,,,,,,
1573,Back Cover qinque,1000,20,20000,,,,,,,,,,,,
1574,Nest Qinque,2020,20,40400,,,,,,,,,,,,
1575,,,,79335,,,,,,,,,,,,
1576,upper Cover  Qinque,410,45,18450,30-12-14,,,,,,,,,,,
1577,Upper Cover  window,168,35,5880,,,,,,,,,,,,
1578,Back Cover 70,358,30,10740,,,,,,,,,,,,
1579,,,,35070,,,,,,,,,,,,
1580,upper Cover  Qinque,706,45,31770,31-12-14,,,,,,,,,,,
1581,Back Cover qinque,1550,20,31000,,,,,,,,,,,,
1582,hosing qinque,757,35,26495,,,,,,,,,,,,
1583,Upper Cover  window,466,35,16310,,,,,,,,,,,,
1584,Back Cover 70,342,30,10260,,,,,,,,,,,,
1585,,,,115835,,,,,,,,,,,,
1586,Upper Cover  window,434,35,15190,02-01-15,,,,,,,,,,,
1587,Hosing 70Black,1068,8,8544,,,,,,,,,,,,
1588,Hosing Qinque,492,35,17220,,,,,,,,,,,,
1589,Nest Qinque,1620,20,32400,,,,,,,,,,,,
1590,Back Cover 70,400,30,12000,,,,,,,,,,,,
1591,,,,85354,,,,,,,,,,,,
1592,Upper Cover  window,564,35,19740,03-01-15,,,,,,,,,,,
1593,Hosing 70Black,590,8,4720,,,,,,,,,,,,
1594,hosing qinque,522,35,18270,,,,,,,,,,,,
1595,,,,42730,,,,,,,,,,,,
1596,Upper Cover Window,450,35,15750,05-01-15,,,,,,,,,,,
1597,Back Cover 70,564,30,16920,,,,,,,,,,,,
1598,Hosing 70Black,654,8,5232,,,,,,,,,,,,
1599,,,,37902,,,,,,,,,,,,
1600,Upper Cover Window,531,35,18585,07-01-15,,,,,,,,,,,
1601,Back Cover 70,813,30,24390,,,,,,,,,,,,
1602,Hosing 70Black,705,8,5640,,,,,,,,,,,,
1603,,,,48615,,,,,,,,,,,,
1604,Upper Cover  window,1062,35,37170,09-01-15,,,,,,,,,,,
1605,Back Cover 70,717,30,21510,,,,,,,,,,,,
1606,Hosing 70Black,750,8,6000,,,,,,,,,,,,
1607,,,,64680,,,,,,,,,,,,
1608,Hoiusing qinque,411,35,14385,12-01-15,,,,,,,,,,,
1609,dial Blank qinque,1640,12,19680,13-01-15,,,,,,,,,,,
1610,upper Cover  Qinque 125,230,45,10350,,,,,,,,,,,,
1611,upper Cover  Qinque 125,200,45,9000,,,,,,,,,,,,
1612,,,,39030,,,,,,,,,,,,
1613,Upper Cover  window,448,35,15680,14-01-15,,,,,,,,,,,
1614,upper Cover  Qinque 125,300,45,13500,,,,,,,,,,,,
1615,Back Cover 70,741,30,22230,,,,,,,,,,,,
1616,Hosing 70Black,985,8,7880,,,,,,,,,,,,
1617,,,,59290,,,,,,,,,,,,
1618,Dial Blank qinque,3000,12,36000,15-01-15,,,,,,,,,,,
1619,upper Cover  Qinque 125,270,45,12150,15-01-15,,,,,,,,,,,
1620,Upper Cover Window,188,35,6580,,,,,,,,,,,,
1621,Back Cover 70,222,30,6660,,,,,,,,,,,,
1622,Hosing 70Black,375,8,3000,,,,,,,,,,,,
1623,,,,28390,,,,,,,,,,,,
1624,Upper Cover  window,459,35,16065,17-01-15,,,,,,,,,,,
1625,Back Cover 70,750,30,22500,,,,,,,,,,,,
1626,Hosing 70Black,835,8,6680,,,,,,,,,,,,
1627,Upper Cover Window,265,35,9275,,,,,,,,,,,,
1628,Back Cover 70,410,30,12300,,,,,,,,,,,,
1629,Hosing 70Black,327,8,2616,,,,,,,,,,,,
1630,,,,69436,,,,,,,,,,,,
1631,Upper Cover Window,269,35,9415,19-01-15,,,,,,,,,,,
1632,Back Cover 70,408,30,12240,,,,,,,,,,,,
1633,,,,21655,,,,,,,,,,,,
1634,upper Cover  Qinque,660,45,29700,22-01-15,,,,,,,,,,,
1635,hosing qinque,256,35,8960,,,,,,,,,,,,
1636,Upper Cover  window,203,35,7105,,,,,,,,,,,,
1637,,,,45765,,,,,,,,,,,,
1638,Upper Cover  window,220,35,7700,23-01-15,,,,,,,,,,,
1639,,,,0,,,,,,,,,,,,
1640,,,,0,,,,,,,,,,,,
1641,,,,0,,,,,,,,,,,,
1642,,,,0,,,,,,,,,,,,
1643,,,,0,,,,,,,,,,,,
1644,,,,0,,,,,,,,,,,,
1645,,,,0,,,,,,,,,,,,
1646,,,,0,,,,,,,,,,,,
1647,,,,0,,,,,,,,,,,,
1648,,,,0,,,,,,,,,,,,
1649,,,,0,,,,,,,,,,,,
1650,,,,0,,,,,,,,,,,,
1651,,,,0,,,,,,,,,,,,
1652,,,,0,,,,,,,,,,,,
1653,,,,0,,,,,,,,,,,,
1654,,,,0,,,,,,,,,,,,
1655,,,,0,,,,,,,,,,,,
1656,,,,0,,,,,,,,,,,,
1657,,,,0,,,,,,,,,,,,
1658,,,,0,,,,,,,,,,,,
1659,,,,0,,,,,,,,,,,,
1660,,,,0,,,,,,,,,,,,
1661,,,,0,,,,,,,,,,,,
1662,,,,0,,,,,,,,,,,,
1663,,,,0,,,,,,,,,,,,
1664,,,,0,,,,,,,,,,,,
1665,,,,0,,,,,,,,,,,,
1666,,,,0,,,,,,,,,,,,
1667,,,,0,,,,,,,,,,,,
1668,,,,0,,,,,,,,,,,,
1669,,,,0,,,,,,,,,,,,
1670,,,,0,,,,,,,,,,,,
1671,,,,0,,,,,,,,,,,,
1672,,,,0,,,,,,,,,,,,
1673,,,,0,,,,,,,,,,,,
1674,,,,0,,,,,,,,,,,,
1675,,,,0,,,,,,,,,,,,
1676,,,,0,,,,,,,,,,,,
1677,,,,0,,,,,,,,,,,,
1678,,,,0,,,,,,,,,,,,
1679,,,,0,,,,,,,,,,,,
1680,,,,,,,,,,,,,,,,
1681,,,,,,,,,,,,,,,,
1682,,,,,,,,,,,,,,,,
1683,,,,,,,,,,,,,,,,
